border_size=1
usage=map

Aa^Fpa      , Aa^Fpa      , Aa^Fpa      , Aa^Fpa      , Aa^Fpa      , Aa^Fpa      , Aa^Fpa      , Aa^Fpa      , Ha          , Ha          , Ms          , Ms          , Ms          , Ms          , Ms          , Ms          , Ms          , Ms          , Ms          , Ms          , Ms          , Ms          
Aa^Fpa      , Ha^Fpa      , Aa^Fpa      , Aa^Fpa      , Aa          , Aa^Fpa      , Aa^Fpa      , Aa^Fpa      , Aa^Fpa      , Ha          , Ms          , Ms          , Ms          , Ms          , Ms          , Ms          , Ms          , Ms          , Ms          , Ms          , Ha          , Ha          
Aa^Fpa      , Aa^Fpa      , Aa^Vha      , Aa^Fpa      , Aa^Fpa      , Aa^Fpa      , Ha^Fpa      , Aa^Fpa      , Aa^Fpa      , Ha          , Ha          , Ms          , Ms          , Ha          , Ha          , Ms          , Ha          , Ha          , Ha          , Ha          , Re          , Re          
Aa^Fpa      , Aa^Fpa      , Aa^Fpa      , Aa^Fpa      , Aa^Fpa      , Aa^Fpa      , Aa          , Aa^Fpa      , Ha^Fpa      , Aa^Fpa      , Aa^Fpa      , Ha          , Ha          , Ha          , Ce          , Ha          , Ce          , Ha          , 1 Ke        , Re          , Re          , Re          
Aa^Fpa      , Aa^Fpa      , Aa^Fpa      , Ha^Fpa      , Ha^Fpa      , Aa^Fpa      , Aa^Fpa      , Ha^Fpa      , Ha^Fpa      , Aa^Fpa      , Aa^Fpa      , Aa^Fpa      , Aa          , Aa          , Aa          , Ce          , Ce          , Ce          , Re          , Re          , Re          , Aa          
Aa^Fpa      , Aa^Fpa      , Aa^Fpa      , Ha          , Aa^Fpa      , Ha^Fpa      , Aa^Fpa      , Aa^Fpa      , Aa^Fpa      , Aa^Fpa      , Aa          , Aa          , Aa          , Aa          , Re          , Re          , Re          , Re          , Re          , Re          , Ha          , Ha          
Aa^Fpa      , Ha^Fpa      , Aa          , Aa^Fpa      , Aa^Fpa      , Aa^Fpa      , Aa          , Aa^Fpa      , Aa          , Aa^Vha      , Re          , Aa          , Re          , Re          , Re          , Re          , Aa          , Aa          , Ha          , Ha          , Ms          , Ha          
Aa^Fpa      , Aa^Fpa      , Aa^Fpa      , Aa^Fpa      , Aa          , Aa          , Aa          , Aa          , Re          , Re          , Re          , Re          , Re          , Re          , Aa^Fpa      , Aa^Fpa      , Aa^Fpa      , Aa          , Ha          , Mm^Vhh      , Ms          , Ms          
Aa^Fpa      , Aa^Fpa      , Aa          , Aa          , Re          , Re          , Re          , Re          , Re          , Re          , Aa          , Re          , Re          , Aa^Vha      , Aa^Fpa      , Aa^Fpa      , Aa^Fpa      , Aa          , Ha          , Ms          , Ai          , Ai          
Aa          , Aa          , Re          , Re          , Re          , Re          , Re          , Re          , Aa          , Aa          , Aa          , Re          , Re          , Aa          , Aa^Fpa      , Ha^Fpa      , Aa^Fpa      , Aa          , Ai          , Ai          , Ha          , Ms          
Re          , Re          , Re          , Re          , Aa          , Aa^Vha      , Aa          , Aa          , Aa^Fpa      , Aa^Fpa      , Aa          , Re          , Re          , Aa          , Aa^Fpa      , Aa          , Aa^Fpa      , Ai          , Ha          , Ms          , Ms          , Ms          
Re          , Re          , Aa          , Aa          , Ha          , Aa          , Aa^Fpa      , Aa^Fpa      , Ha          , Aa^Fpa      , Aa          , Re          , Re          , Aa          , Aa^Fpa      , Aa^Fpa      , Ai          , Ai          , Ha          , Ms          , Ms          , Ms          
Aa          , Aa          , Aa          , Ha          , Ha^Fpa      , Aa^Fpa      , Re          , Aa^Fpa      , Aa^Fpa      , Ha          , Re          , Re          , Re          , Aa          , Ha          , Aa^Fpa      , Ai          , Aa^Fpa      , Aa^Fpa      , Ha^Vhha     , Ha          , Ms          
Aa          , Aa          , Aa^Fpa      , Ha          , Aa^Fpa      , Aa^Fpa      , Aa^Fpa      , Aa^Fpa      , Aa^Fpa      , Aa          , Re          , Re          , Aa          , Ha^Vhha     , Ha          , Ha^Fpa      , Aa^Fpa      , Ai          , Ai          , Aa^Fpa      , Aa^Fpa      , Ha          
Aa          , Aa          , Aa^Fpa      , Aa^Fpa      , Aa^Fpa      , Aa          , Ha^Fpa      , Aa^Fpa      , Aa^Vha      , Aa          , Re          , Re          , Aa          , Aa^Fpa      , Aa^Fpa      , Aa^Fpa      , Ha^Fpa      , Aa^Fpa      , Re          , Ai          , Ai          , Aa^Fpa      
Aa^Fpa      , Aa^Fpa      , Aa^Fpa      , Ha^Fpa      , Aa^Fpa      , Ha^Fpa      , Aa^Fpa      , Aa^Fpa      , Aa^Fpa      , Aa          , Re          , Re          , Aa          , Aa^Fpa      , Aa^Fpa      , Aa^Fpa      , Aa^Fpa      , Aa^Fpa      , Aa^Vha      , Aa^Fpa      , Ai          , Aa          
Aa^Fpa      , Aa^Fpa      , Aa^Vha      , Aa^Fpa      , Ha^Fpa      , Re          , Aa^Fpa      , Aa^Fpa      , Aa^Fpa      , Aa          , Re          , Re          , Aa          , Aa^Fpa      , Aa^Fpa      , Re          , Aa^Fpa      , Aa^Fpa      , Aa^Fpa      , Aa^Fpa      , Ai          , Aa          
Aa^Fpa      , Aa^Fpa      , Aa^Fpa      , Aa^Fpa      , Ha^Fpa      , Aa^Fpa      , Aa^Fpa      , Aa^Fpa      , Aa^Fpa      , Aa          , Re          , Re          , Re          , Aa          , Aa          , Aa^Fpa      , Ha          , Ha^Fpa      , Ai          , Ai          , Aa^Fpa      , Aa^Fpa      
Aa^Fpa      , Aa^Fpa      , Aa^Fpa      , Ha          , Aa^Fpa      , Aa^Fpa      , Ce          , Ce          , Ce          , Aa          , Aa          , Re          , Ai          , Ai          , Ai          , Ai          , Ai          , Ai          , Aa^Fpa      , Ha          , Aa^Fpa      , Aa^Fpa      
Ha          , Aa^Fpa      , Aa^Fpa      , Aa^Fpa      , Aa^Fpa      , Aa^Fpa      , Ce          , 2 Ke        , Ce          , Aa          , Ai          , Ai          , Re          , Aa          , Aa^Vha      , Aa^Fpa      , Aa^Fpa      , Ha          , Ha^Fpa      , Ha          , Aa^Fpa      , Aa^Fpa      
Ha          , Ha          , Ha^Vhha     , Aa^Fpa      , Aa^Fpa      , Aa^Fpa      , Aa^Fpa      , Ce          , Aa^Fpa      , Aa^Fpa      , Ai          , Re          , Re          , Aa          , Aa          , Aa^Fpa      , Ha          , Ha^Fpa      , Aa^Fpa      , Aa^Fpa      , Ha^Fpa      , Aa^Fpa      
Ha          , Ha          , Ha          , Ha          , Ha          , Aa^Fpa      , Aa^Fpa      , Aa^Fpa      , Ai          , Ai          , Aa          , Re          , Re          , Aa          , Aa          , Aa^Fpa      , Ha          , Ha          , Aa^Fpa      , Aa^Fpa      , Aa^Fpa      , Aa^Fpa      
