border_size=1
usage=map

Ww          , Ww          , Ms          , Ms          , Ms          , Ms          , Ms          , Ms          , Ms          , Ms          , Ms          , Ms          , Ms          , Ms          , Ms          , Ms          , Ms          , Ms          , Ms          , Ms          , Ms          , Re          , Re          , Mm          
Ww          , Ms          , Ms          , Ms          , Ms          , Ms          , Ms          , Ms          , Ms          , Ms          , Ms          , Ms          , Ms          , Ms          , Ms          , Ms          , Ms          , Ms          , Ms          , Ms          , Ms          , Ms          , Ms          , Re          
Ai          , Ms          , Ms          , Ms          , Ms          , Ms          , Ms          , Ms          , Ha^Fpa      , Ms          , Ms          , Ms          , Ms          , Ha^Fpa      , Ha^Fpa      , Ha          , Ha^Vhha     , Ms          , Ms          , Ms          , Aa^Fpa      , Ms          , Ms          , Ha          
Ww          , Ai          , Ww          , Ms          , Ha          , Ms          , Aa^Fpa      , Ms          , Ms          , Ha^Fpa      , Aa^Fpa      , Ha^Fpa      , Ha^Fpa      , Ha^Fpa      , Ce          , Ce          , Ha^Fpa      , Ms          , Ha^Fpa      , Ms          , Ha^Fpa      , Ms          , Re          , Re          
Mm          , Ww          , Ww          , Ww          , Ww          , Ms          , Ms          , Aa^Fpa      , Aa^Fpa      , Ha          , Aa          , Ha          , Aa^Fpa      , Ce          , Ce          , 1 Ke        , Ce          , Ha          , Re          , Ha^Fpa      , Re          , Re          , Ms          , Hh          
Mm          , Mm          , Ha          , Ww          , Ww          , Ai          , Ms          , Ms          , Ha^Fpa      , Ha          , Aa^Fpa      , Aa          , Gg^Efm      , Ce          , Ce          , Ce          , Re          , Re          , Aa^Fpa      , Re          , Ha^Fpa      , Ms          , Ms          , Ms          
Mm          , Mm          , Ha          , Gs^Fp       , Wo          , Ai          , Ms          , Ms          , Ha^Fpa      , Aa^Fpa      , Aa^Fpa      , Aa          , Gg^Efm      , Gg^Efm      , Gg^Efm      , Re          , Gg^Efm      , Aa^Fpa      , Ha          , Aa^Fpa      , Ms          , Ms          , Ms          , Ms          
Ha          , Ha          , Gs^Fp       , Ww          , Ww          , Ha^Fpa      , Ms          , Ms^Vhha     , Ha          , Aa^Fpa      , Aa          , Gg^Efm      , Gg^Efm      , Gg^Efm      , Re          , Re          , Gg^Efm      , Ha          , Ms^Vhha     , Ha^Fpa      , Ha^Fpa      , Ha          , Ms          , Ms          
Gs^Fp       , Gs^Fp       , Gs^Fp       , Ww          , Ww          , Ha^Fpa      , Ha          , Ha          , Gs^Fp       , Aa^Fpa      , Gg^Efm      , Gg^Efm      , Re          , Re          , Gg^Efm      , Gg^Efm      , Aa^Fpa      , Ha^Fpa      , Ms          , Ms          , Ms          , Ms          , Ms          , Ms          
Gg^Efm      , Gs^Fp       , Gs^Fp       , Ww          , Wwf         , Gs^Fp       , Gs^Fp       , Gs^Fp       , Gs^Fp       , Gg^Efm      , Re          , Re          , Gg^Efm      , Gg^Efm      , Aa^Fpa      , Aa^Fpa      , Ha^Fpa      , Ha^Fpa      , Ms          , Ms          , Ms          , Ha^Fpa      , Ha          , Ha          
Gg^Efm      , Gg^Efm      , Gg^Efm      , Wwf         , Wwf         , Gs^Fp       , Gg^Efm      , Gg^Efm      , Gg^Efm      , Gg^Efm      , Re          , Gg^Efm      , Gg^Efm      , Gg^Efm      , Aa^Fpa      , Aa^Fpa      , Ms^Vhha     , Ha^Fpa      , Aa^Fpa      , Ha          , Ms          , Ms          , Ha          , Aa^Fpa      
Gg^Efm      , Gg^Efm      , Gg^Efm      , Wwf         , Ww          , Ss^Vhs      , Mm          , Hh          , Hh          , Gg^Efm      , Re          , Gg^Efm      , Gg^Efm      , Aa^Fpa      , Ha^Fpa      , Ha^Fpa      , Ms          , Ha          , Ha          , Ms          , Ha          , Ha          , Aa^Fpa      , Aa^Fpa      
Gg^Efm      , Gg^Efm      , Ss          , Ww          , Ww          , Gs^Fp       , Mm          , Mm          , Mm          , Gs^Fp       , Re          , Gg^Efm      , Gg^Efm      , Aa^Fpa      , Ha          , Ms          , Mm          , Mm          , Mm          , Ha          , Aa^Fpa      , Aa^Fpa      , Aa          , Aa^Fpa      
Gg^Efm      , Gg^Efm      , Ss          , Ww          , Ww          , Gs^Fp       , Mm          , Mm          , Hh          , Gs^Fp       , Re          , Gg^Efm      , Gs^Fp       , Aa^Fpa      , Mm          , Mm          , Mm          , Mm          , Ha          , Ha          , Gg^Vh       , Aa          , Rr          , Rr          
Hh          , Hh          , Hh          , Ww          , Ww          , Gs^Fp       , Hh          , Mm          , Hh          , Gs^Fp       , Re          , Gg^Ve       , Gs^Fp       , Hh^Fp       , Mm          , Mm          , Hh^Fp       , Mm          , Gs^Fp       , Aa^Fpa      , Rr          , Rr          , Gg          , Aa          
Hh          , Mm          , Ss          , Ww          , Ww          , Gs^Fp       , Gs^Fp       , Mm          , Mm          , Gs^Fp       , Re          , Gs^Fp       , Gs^Fp       , Hh^Fp       , Hh^Fp       , Mm          , Hh          , Gs^Fp       , Rr          , Rr          , Gg          , Gg          , Ce          , Gg          
Gs^Fp       , Gs^Fp       , Ss          , Ww          , Ww          , Ww          , Ww          , Mm          , Gg^Efm      , Gg^Efm      , Gg^Efm      , Re          , Re          , Gs^Fp       , Gs^Fp       , Hh          , Rr          , Rr          , Gg          , Gg          , Ce          , Ce          , Gs^Fp       , Gs^Fp       
Gs^Fp       , Ss          , Ss^Vhs      , Hh^Fp       , Ww          , Wo          , Ww          , Gg^Efm      , Hh          , Gs^Fp       , Ss          , Gs^Fp       , Gs^Fp       , Re          , Rr          , Rr          , Gg          , Gg          , Gg          , 3 Ce        , Gg^Ve       , 2 Ke        , Hh          , Hh          
Gs          , Gs^Fp       , Gg          , Re          , Mm          , Ww          , Ww          , Ww          , Wwf         , Hh^Vhh      , Hh          , Gs^Fp       , Gs^Fp       , Ss          , Rr          , Re          , Gs^Fp       , Gg          , Gg          , Gg          , Gs^Fp       , Gs^Fp       , Hh          , Mm          
Gs          , Gg          , Gg          , Gs^Fp       , Mm          , Hh^Fp       , Hh^Fp       , Ww          , Wwf         , Hh          , Hh^Fp       , Gs^Fp       , Gg          , Re          , Rr          , Ss          , Gs^Fp       , Gs^Fp       , Gs^Fp       , Gs^Fp       , Hh^Fp       , Hh          , Ms          , Ms          
Gs          , Gg          , Gg          , Gs^Fp       , Hh^Fp       , Mm          , Mm          , Ww          , Wwf         , Hh          , Gs^Fp       , Gg          , Gg          , Re          , Rr          , Ss          , Gs^Fp       , Hh^Fp       , Hh          , Gs^Fp       , Hh^Fp       , Ha^Fpa      , Ms          , Ms          
Gs          , Gs          , Gg          , Re          , Ss          , Hh          , Gs^Fp       , Ww          , Wwf         , Hh          , Gs^Fp       , Gg          , Gg          , Re          , Rr          , Hh^Fp       , Hh^Fp       , Hh          , Hh^Vhh      , Hh          , Mm          , Ms          , Ms          , Ms          
Gs          , Gs          , Gg          , Gs^Fp       , Gs^Fp       , Ss          , Ss          , Ww          , Ww          , Gg          , Gg          , Gg          , Gg          , Gg          , Rr          , Gs^Fp       , Gs^Fp       , Hh^Fp       , Hh          , Mm          , Mm          , Mm          , Ha^Fpa      , Mm          
Gg          , Gg          , Gg          , Hh          , Hh^Fp       , Ss          , Gs^Fp       , Ww          , Ww          , Gg^Vc       , Re^Gvs      , Re^Gvs      , Re^Gvs      , Gg          , Rr          , Gg          , Gs^Fp       , Hh^Fp       , Hh          , Hh          , Hh          , Hh^Fp       , Hh          , Mm          
Gs^Fp       , Gg^Vc       , Re^Gvs      , Mm          , Hh^Fp       , Ss          , Ss          , Ww          , Ww          , Gg          , Re^Gvs      , Re^Gvs      , Re^Gvs      , Hh          , Rr          , Gg          , Gg          , Gg          , Gg          , Gs^Fp       , Gs^Fp       , Hh^Fp       , Gs^Fp       , Hh          
Gs^Fp       , Re^Gvs      , Re^Gvs      , Re^Gvs      , Re^Gvs      , Gs^Fp       , Gs^Fp       , Ww          , Ww          , Gg          , Gg          , Re^Gvs      , Re^Gvs      , Hh^Fp       , Rr          , Gg          , Re^Gvs      , Re^Gvs      , Re^Gvs      , Gg          , Gg          , Gs^Fp       , Gs^Fp       , Gs^Fp       
Hh^Fp       , Re^Gvs      , Re^Gvs      , Re^Gvs      , Re^Gvs      , Re^Gvs      , Gg          , Ww          , Ww          , Ww          , Ww          , Gg          , Gg          , Hh          , Rr          , Gg          , Re^Gvs      , Re^Gvs      , Re^Gvs      , Re^Gvs      , Re^Gvs      , Gg          , Gs^Fp       , Gs^Fp       
Hh^Fp       , Hh^Fp       , Re^Gvs      , Re^Gvs      , Re^Gvs      , Re^Gvs      , Gg          , Gg          , Gg^Wm       , Ww          , Ww          , Ww          , Wwf         , Gg          , Rr          , Gg          , Re^Gvs      , Re^Gvs      , Re^Gvs      , Re^Gvs      , Re^Gvs      , Gg^Vc       , Gg          , Gs^Fp       
Gs^Fp       , Gs^Fp       , Gs^Fp       , Re^Gvs      , Gg          , Gg          , Hh          , Hh          , Hh          , Gg          , Ce          , Wwf         , Ww^Bw/      , Ww^Bw/      , Ww          , Gg          , Gg          , Re^Gvs      , Re^Gvs      , Re^Gvs      , Re^Gvs      , Re^Gvs      , Gg          , Gg          
Gs^Fp       , Re^Gvs      , Re^Gvs      , Gs^Fp       , Gg          , Hh          , Ce          , Ce          , Ce          , Hh          , Rr          , Rr          , Ce          , Ww          , Ww          , Ww          , Ww          , Hh          , Hh          , Re^Gvs      , Hh          , Gg          , Gs^Fp       , Hh^Fp       
Gs^Fp       , Re^Gvs      , Re^Gvs      , Re^Gvs      , Gg          , Rp^Vhc      , Ce          , Ke          , Rr          , Rr          , Gg          , Rp^Vhc      , Gg          , Gg          , Gg          , Ww          , Ww          , Ww          , Ww          , Hh^Fp       , Ww          , Hh^Fp       , Ss          , Gs^Fp       
Gs^Fp       , Re^Gvs      , Re^Gvs      , Gg          , Ce          , Gg          , Rr          , Rr          , Gg          , Rp^Vhc      , Gg          , Gg          , Gg^Vh       , Gg          , Gg          , Hh          , Hh^Fp       , Ww          , Ww          , Ww          , Wo          , Ww          , Ww          , Hh          
Gs^Fp       , Re^Gvs      , Gg^Vc       , Gg          , Rr          , Rr          , Ce          , Rp^Vhc      , Gg          , Gg          , Gg^Vh       , Gg          , Gg          , Gg          , Hh          , Hh^Fp       , Hh^Fp       , Hh^Fp       , Mm          , Ww          , Ww          , Wo          , Wo          , Ww          
Gs^Fp       , Gg          , Gg          , Gg          , Rr          , Gg          , Gg          , Gg          , Gg          , Gg          , Gg          , Gg          , Gs^Fp       , Gs^Fp       , Gs^Fp       , Gs^Fp       , Hh          , Gs^Fp       , Gs^Fp       , Hh          , Hh          , Ww          , Ww          , Wo          
