Gs^Fp, Gs^Fp, Gs^Fp, Gs^Fp, Gs^Fp, Gs^Fp, Gs^Fp, Gs^Fp, Gs^Fp, Gs^Fp, Ss, Ss, Gs^Fp, Gs^Fp, Gs^Fp, Gs^Fp, Gs^Fp, Gs^Fp, Gs^Fp, Gs^Fp, Gs^Fp, Gs^Fp, Gs^Fp, Gs^Fp, Gs^Fp, Gs^Fp, Gs^Fp, Gg, Rp, Chr, Gg, Gg
Gs^Fp, Gs^Fp, Ss^Vhs, Gs^Fp, Ss, Gs^Fp, Ss, Ss, Gs^Fp, Gs^Fp, Ss, Gs^Fp, Gs^Fp, Gs^Fp, Gs^Fp, Gs^Fp, Ce, Gs^Fp, Gs^Fp, Gs^Fp, Gs^Fp, Gs^Fp, Gs^Fp, Gs^Fp, Gs^Fp, Gs^Fp, Gs^Fp, Chr, Rp, Chr, Gg, Gg
Ss, Ss, Gs^Fp, Gs^Fp, Ss, Ss, Ss, Gs^Fp, Gs^Fp, Gs^Fp, Gs^Fp, Gs^Fp, Gg, Gg, Gg, Ce, 1 Ke, Ce, Gg^Vc, Gg, Gg, Gs^Fp, Gg, Gs^Fp, Gs^Fp, Gs^Fp, Gs^Fp, Rp, Chr, Rp, Gg, Gg
Gs^Fp, Ss, Gs^Fp, Ss, Ss, Gs^Fp, Gs^Fp, Gs^Fp, Gs^Fp, Gs^Fp, Gg, Gg, Gg, Gg, Gg, Ce, Ce, Ce, Gg, Gg, Gg, Gg, Gg, Gg, Gg, Gs^Fp, Gg, Gg, Gg, Gg, Rp, Gg
Hh^Fp, Gs^Fp, Hh^Fp, Gs^Fp, Gs^Fp, Ss, Gs^Fp, Gs^Fp, Gs^Fp, Gg^Vc, Gg, Gg, Gg^Efm, Gg, Gg, Gg, Gg, Gg, Rp, Rp, Rp, Gg, Gg^Efm, Gg^Efm, Gg, Gg, Rp, Rp, Rp, Rp, Ww, Ww
Hh^Fp, Hh^Fp, Gs^Fp, Gs^Fp, Rp, Re, Rd, Gs^Fp, Rp, Gg, Gg^Efm, Gg^Efm, Gg^Efm, Gg, Gg^Efm, Gg, Rp, Rp, Gg, Gg, Gg, Gg, Gg, Gg^Efm, Gg, Gg, Gg, Gg, Ww, Ww, Ww, Ww
Gs^Fp, Gs^Fp, Rp, Gs^Fp, Gs^Fp, Gs^Fp, Gs^Fp, Rp, Gs^Fp, Rd, Rd, Gg^Efm, Gg^Efm, Gg^Efm, Gg, Rd, Gg, Gg, Gg, Gg, Gs^Fp, Gg, Gg, Gg^Efm, Gg, Gg, Ww, Ww, Ww, Ww, Gg^Ve, Gg
Gs^Fp, Re, Ss, Gs^Fp, Hh^Fp, Gs^Fp, Hh, Gs^Fp, Gs^Fp, Gg^Efm, Gg, Rd, Rd, Rd, Gg^Efm, Gg, Gg^Vc, Gg, Hh, Gs^Fp, Mm, Gs^Fp, Hh, Gg, Ww, Ww, Ww, Ww, Hh, Gg, Gg, Gg
Gs^Fp, Gs^Fp, Ss, Gs^Fp, Gs^Fp, Gs^Fp, Ss, Hh^Fp, Gs^Fp, Gg, Gg, Gg^Efm, Gg^Efm, Gg^Efm, Gg, Gg, Gs^Fp, Hh, Mm, Mm, Hh, Hh, Hh, Hh, Ww, Ww, Mm, Hh, Gs^Fp, Gg, Gg, Gg
Gs^Fp, Gs^Fp, Hh^Fp, Hh, Hh^Fp, Gs^Fp, Gs^Fp, Gs^Fp, Gs^Fp, Gg^Vc, Gg, Gg, Gg^Efm, Gg^Efm, Gg, Gg, Gs^Fp, Mm, Hh, Hh, Wwr, Wwr, Ww, Ww, Ww, Ww, Ww, Hh, Ww, Gg, Gg, Gg
Gs^Fp, Gs^Fp, Ss, Hh, Hh^Fp, Ss, Hh^Fp, Gs^Fp, Gs^Fp, Gs^Fp, Gg, Gg, Gg^Efm, Gg^Efm, Gg, Gg, Hh, Mm, Hh, Wwr, Ww, Ww, Ww, Ww, Gs^Fp, Hh, Gs^Fp, Ww, Gg, Wwf, Wwf, Gg
Gs^Fp, Ss^Vhs, Ss, Gs^Fp, Gs^Fp, Gs^Fp, Hh^Fp, Gs^Fp, Gs^Fp, Gs^Fp, Gg, Gg, Gg, Gg, Gg, Gg, Gg, Hh, Ww, Ww, Wwr, Gs^Fp, Hh, Gs^Fp, Gs^Fp, Gs^Fp, Gg, Gg, Gg, Gg, Gg, Wwf
Gs^Fp, Gs^Fp, Gs^Fp, Ss, Ss, Gs^Fp, Ss, Hh, Ss, Gs^Fp, Gs^Fp, Gg, Gg, Gg, Gg, Gg^Vc, Gg, Gg, Ww, Ww, Gs^Fp, Mm, Ce, Hh, Ce, Gg, Gg, Gg, Gg, Gg, Gg, Gg
Gg, Hh^Fp, Gg, Hh^Fp, Hh^Fp, Gs^Fp, Gs^Fp, Hh^Vhh, Hh, Gs^Fp, Gs^Fp, Gg, Gg, Gg, Gs^Fp, Gs^Fp, Gs^Fp, Gs^Fp, Ww, Ww, Gs^Fp, Hh, Ce, 3 Ke, Ce, Gg, Gg, Gg, Gg, Gg, Gg, Gg
Gg, Gg, Ce, Gg, Gg, Gs^Fp, Gs^Fp, Hh, Ss, Gs^Fp, Gs^Fp, Gg, Gg, Gg, Gs^Fp, Gs^Fp, Hh^Fp, Hh, Ww, Ww, Wwr, Gs^Fp, Gs^Fp, Ce, Gg, Gg, Gg, Gg^Vc, Gg, Gg, Gg, Gg
Gg, Ce, 2 Ke, Ce, Gg, Gs^Fp, Gs^Fp, Gs^Fp, Gs^Fp, Gs^Fp, Hh, Gg, Gg, Gg^Efm, Gs^Fp, Gs^Fp, Hh, Hh, Ww, Ww, Ww, Gs^Fp, Hh^Fp, Gs^Fp, Gs^Fp, Gg, Gg, Gg, Rr, Rr, Rr, Gg
Gg, Ce, Ce, Ce, Gg, Hh, Gs^Fp, Gs^Fp, Re, Ss, Hh, Gg, Gg, Gg^Efm, Gg, Gs^Fp, Hh, Hh, Hh^Fp, Ww, Ww, Ww, Ww, Hh^Fp, Hh^Fp, Gs^Fp, Rr, Rr, Gg, Gg, Gg, Rr
Gg, Gg, Gg, Gg, Gg, Gg, Gs^Fp, Hh^Fp, Hh, Ss, Hh, Gg, Gg, Gg^Efm, Gg^Efm, Gg, Gg^Vc, Gs^Fp, Gs^Fp, Hh, Hh, Ww, Ww, Ww, Ww^Bw/, Rr, Hh, Gs^Fp, Gs^Fp, Gg, Gg, Gg
Gg, Gg, Gg, Gg, Gg, Gg, Gs^Fp, Gs^Fp, Ss, Hh^Fp, Gs^Fp, Gg, Gg, Gg, Gg, Gg, Gg, Gs^Fp, Gs^Fp, Hh, Hh^Fp, Hh, Rr, Ww^Bw/, Ww, Ww, Ww, Hh^Fp, Hh^Fp, Gs^Fp, Gg, Gg
Gg, Gg, Gg, Gg, Gg, Gg, Hh^Fp, Gs^Fp, Hh^Fp, Gs^Fp, Gs^Fp, Gg, Gg, Gg, Gg, Gg, Gg, Gs^Fp, Gs^Fp, Gs^Fp, Gg, Rr, Gs^Fp, Gs^Fp, Ss, Ww, Ww, Hh, Hh^Fp, Gs^Fp, Gg, Gg
Gg, Gg, Gg, Gg^Vc, Gg, Gg, Gg, Gs^Fp, Gs^Fp, Gs^Fp, Gg^Vc, Gg, Gg, Gg, Gg, Gg, Gg, Gg, Gg, Gg, Gg, Rr, Gs^Fp, Ss, Gs^Fp, Ww, Ww, Ww, Hh^Fp, Gs^Fp, Gg, Gg
Gg, Gg, Gg, Gg, Gg, Gg, Gg, Gg, Gg, Gg, Gg, Gg, Gg, Gg, Gg, Gg, Gg, Gg, Gg, Gg, Rr, Rr, Gg, Ss^Vhs, Gs^Fp, Hh^Fp, Wwf, Ww, Gg, Gg^Vc, Gg, Gg
Gs^Fp, Gg, Gg, Gg, Gg, Gg, Gg, Gg, Gg, Gg, Gg, Gg, Gg, Gg, Gg, Gg, Gg, Gg, Rr, Rr, Gg, Gg, Hh^Fp, Gg, Gg, Gs^Fp, Wwf, Wwf, Gg, Gg, Gg, Gg
Gs^Fp, Gs^Fp, Gs^Fp, Gg, Gg, Gg, Gg, Gg, Gg, Gg, Gg, Gg, Kh, Gg^Ve, Ch, Gg, Rr, Rr, Gg, Gg, Hh^Fp, Gs^Fp, Mm, Hh^Fp, Hh, Gg, Wwf, Wwf, Gg, Gg, Gg, Gg
Hh^Fp, Gs^Fp, Gs^Fp, Gg, Gg, Gg, Gg, Gg, Gg, Gg, Gg, Gg^Ve, Ch, Ch, Rr, Rr, Ch, Gg, Gg, Hh^Fp, Hh, Mm, Mm, Mm, Ww, Ww, Ww, Wwf, Gg, Gg, Gg, Gg
Hh^Fp, Hh^Fp, Gs^Fp, Gg, Gg, Gg^Vc, Gg, Gg, Ww, Ww, Ww, Ch, Rr, Rr, Ch, Ch, Gg^Ve, Gg, Ww, Wwr, Ww, Gs^Fp, Ww, Hh, Ww, Ww, Ww, Hh, Hh^Fp, Gg, Gg, Gg
Hh^Fp, Hh^Fp, Gs^Fp, Gg, Wwr, Gg, Ww, Ww, Ww, Ww, Ww^Bw/, Ww^Bw/, Ww, Ch, Gg^Ve, 5 Kh, Ww, Ww, Ww, Ww, Ww, Ww, Ww, Ww, Ww, Ww, Hh^Fp, Hh, Hh^Fp, Hh^Fp, Gs, Gs
Gs^Fp, Gs^Fp, Ww, Ww, Ww, Ww, Ww, Ww, Gs, Rr, Gs, Ww, Ww, Ww, Ww, Ww, Ww, Ww, Gs^Vht, Hh, Hh, Ww, Hh^Fp, Ww, Hh, Hh^Fp, Hh, Hh^Fp, 4 Ke, Ce, Gs, Gs
Ww, Ww, Ww, Ww, Gs, Ww, Gs, Gs, Gs, Rr, Gs, Gs, Gs, Ww, Ww, Ww, Gs, Gs, Gs, Gs^Fp, Gs^Fp, Hh^Fp, Gs^Fp, Hh^Fp, Gs^Fp, Hh, Gs, Ce, Ce, Ce, Gs, Gs
Ww, Ww, Gs^Fp, Gs^Fp, Gs, Gs^Vht, Gs, Gs, Rr, Rr, Gs, Gs, Gs, Gs, Gs, Gs, Gs, Gs, Gs, Gs, Gs, Gs, Gs, Gs^Fp, Gs, Gs, Gs, Gs^Vht, Gs, Gs, Gs, Gs
Gs^Fp, Hh^Fp, Hh^Fp, Gs^Fp, Gs, Gs, Rr, Rr, Gs, Gs, Gs, Gs, Gs^Fp, Gs, Gs^Fp, Gs, Gs^Fp, Gs, Gs^Fp, Gs, Gs, Gs, Gs, Gs, Gs^Fp, Gs, Gs, Gs, Gs, Gs, Gs, Gs
Hh^Fp, Hh^Fp, Gs^Fp, Gs^Fp, Gs^Fp, Gs, Rd, Gs, Gs, Gs^Fp, Gs^Fp, Gs^Fp, Hh^Fp, Hh^Fp, Hh^Fp, Hh^Fp, Hh^Fp, Hh^Fp, Gs^Fp, Gs^Fp, Gs^Fp, Gs^Fp, Gs^Fp, Gs^Fp, Hh^Fp, Hh^Fp, Hh^Fp, Gs^Fp, Gs^Fp, Gs^Fp, Gs^Fp, Gs
