border_size=1
usage=map

Gs^Ft       , Gs^Ft       , Hh          , Hh          , Mm          , Mm          , Mm^Xm       , Mm          , Mm^Xm       , Mm          , Mm^Xm       , Mm^Xm       , Mm^Xm       , Mm^Xm       , Mm^Xm       , Mm^Xm       , Mm^Xm       , Mm^Xm       , Mm^Xm       , Mm^Xm       , Mm^Xm       , Mm^Xm       , Mm^Xm       , Mm^Xm       , Mm^Xm       , Mm^Xm       , Mm^Xm       , Mm^Xm       , Mm^Xm       , Mm^Xm       , Mm^Xm       , Mm^Xm       , Mm^Xm       , Mm^Xm       , Xu          , Xu          , Xu          , Xu          , Uu          , Wo          , Wo          , Wo          
Gs^Ft       , Ss          , Gs^Ft       , Hh          , Hh          , Hh          , Mm^Xm       , Mm^Xm       , Mm^Xm       , Mm^Xm       , Mm^Xm       , Mm^Xm       , Mm^Xm       , Mm^Xm       , Mm^Xm       , Mm^Xm       , Mm^Xm       , Mm^Xm       , Mm^Xm       , Mm^Xm       , Mm^Xm       , Mm^Xm       , Mm^Xm       , Mm^Xm       , Mm^Xm       , Mm^Xm       , Mm^Xm       , Mm^Xm       , Mm^Xm       , Mm^Xm       , Mm^Xm       , Mm^Xm       , Mm^Xm       , Mm^Xm       , Xu          , Cud         , Uu          , Xu          , Uu          , Wo          , Wo          , Wo          
Gs^Ft       , Gs^Ft       , Ss          , Gs^Ft       , Gs^Ft       , Hh          , Hh          , Mm^Xm       , Mm^Xm       , Mm^Xm       , Mm^Xm       , Mm^Xm       , Mm^Xm       , Mm^Xm       , Mm^Xm       , Mm^Xm       , Mm^Xm       , Mm^Xm       , Mm^Xm       , Mm^Xm       , Mm^Xm       , Mm^Xm       , Mm^Xm       , Mm^Xm       , Mm^Xm       , Mm^Xm       , Mm          , Mm^Xm       , Mm          , Mm^Xm       , Mm^Xm       , Mm^Xm       , Mm^Xm       , Mm^Xm       , Mm^Xm       , Xu          , Xu          , Uu          , Gs^Ft       , Wo          , Wo          , Wo          
Gs          , Gs^Ft       , Gs^Ft       , Gs^Ft       , Ss          , Ss          , Hh          , Hh          , Ss          , Mm^Xm       , Mm^Xm       , Mm^Xm       , Mm^Xm       , Mm^Xm       , Mm^Xm       , Mm^Xm       , Mm^Xm       , Mm^Xm       , Mm^Xm       , Mm^Xm       , Mm^Xm       , Mm^Xm       , Mm^Xm       , Mm^Xm       , Hh          , Mm          , Hh          , Hh          , Hh          , Mm          , Hh          , Mm          , Mm          , Mm          , Mm          , Mm^Xm       , Mm          , Xu          , Gs          , Wo          , Wo          , Wo          
Gs          , Gs          , Gs          , Gs^Ft       , Gs^Ft       , Gs^Ft       , Hh          , Hh          , Hh          , Mm^Xm       , Mm^Xm       , Mm^Xm       , Mm          , Mm^Xm       , Mm^Xm       , Mm^Xm       , Mm^Xm       , Mm^Xm       , Mm^Xm       , Mm^Xm       , Mm^Xm       , Mm^Xm       , Mm          , Mm          , Mm          , Hh          , Gs^Ft       , Gs^Ft       , Gs^Ft       , Hh          , Gs^Ft       , Hh          , Hh          , Mm          , Hh          , Mm          , Hh          , Hh          , Gs          , Wo          , Wo          , Wo          
Gs^Ft       , Gs          , Gs^Ft       , Gs^Ft       , Gs^Ft       , Gs^Ft       , Gs^Ft       , Hh          , Hh          , Mm^Xm       , Mm^Xm       , Mm^Xm       , Mm^Xm       , Mm^Xm       , Mm^Xm       , Mm^Xm       , Mm^Xm       , Mm^Xm       , Mm^Xm       , Mm^Xm       , Mm^Xm       , Mm^Xm       , Mm^Xm       , Mm          , Mm          , Hh          , Gs^Ft       , Ss          , Gs^Ft       , Gs^Ft       , Gs^Ft       , Gs^Ft       , Gs^Ft       , Hh          , Gs^Ft       , Hh          , Gs^Ft       , Gs^Ft       , Gs          , Wo          , Wo          , Wo          
Gs          , Gs^Ft       , Gs          , Gs          , Gs          , Gs^Ft       , Gs^Ft       , Gs^Ft       , Hh          , Mm          , Mm          , Mm^Xm       , Mm^Xm       , Mm^Xm       , Mm^Xm       , Mm^Xm       , Mm^Xm       , Mm^Xm       , Mm^Xm       , Mm^Xm       , Mm^Xm       , Mm^Xm       , Mm          , Mm          , Mm          , Hh          , Gs^Ft       , Gs^Ft       , Gs          , Gs          , Gs          , Gs          , Gs          , Gs^Ft       , Gs^Ft       , Gs^Ft       , Gs          , Gs          , Gs          , Wo          , Wo          , Wo          
Gs          , Gs          , Gs          , Gs          , Gs          , Gs          , Gs^Ft       , Gs^Ft       , Gs^Ft       , Hh          , Hh          , Mm          , Mm          , Mm^Xm       , Mm^Xm       , Mm^Xm       , Mm^Xm       , Mm^Xm       , Mm^Xm       , Mm^Xm       , Mm          , Mm          , Mm          , Mm          , Hh          , Hh          , Gs^Ft       , Gs^Ft       , Gs          , Gs          , Gs          , Gs          , Gs          , Gs          , Gs          , Gs          , Gs          , Gs          , Wo          , Wo          , Wo          , Wo          
Gs          , Gs          , Gs          , Gs          , Gs^Ft       , Gs^Ft       , Gs^Ft       , Gs^Ft       , Gs^Ft       , Gs^Ft       , Hh          , Mm          , Mm          , Mm^Xm       , Mm^Xm       , Mm^Xm       , Mm^Xm       , Mm^Xm       , Mm^Xm       , Mm^Xm       , Mm          , Hh          , Hh          , Hh          , Gs^Ft       , Hh          , Gs^Ft       , Gs^Ft       , Gs          , Gs          , Gs          , Gs          , Gs          , Gs          , Gs          , Gs          , Wo          , Wo          , Wo          , Wo          , Wo          , Wo          
Ww          , Gs          , Ww          , Gs^Ft       , Gs^Ft       , Gs^Ft       , Gs^Ft       , Gs^Ft       , Gs^Ft       , Gs^Ft       , Gs^Ft       , Hh          , Hh          , Mm          , Mm          , Mm^Xm       , Mm^Xm       , Mm^Xm       , Mm^Xm       , Mm^Xm       , Mm          , Hh          , Gs^Ft       , Gs^Ft       , Gs^Ft       , Gs^Ft       , Gs^Vht      , Gs          , Gs          , Gs          , Hh          , Gs          , Gs          , Gs^Vht      , Hh          , Wo          , Wo          , Wo          , Wo          , Wo          , Gg^Ve       , Gg          
Ww          , Ww          , Ww          , Ww          , Ww          , Gs^Ft       , Gs^Ft       , Gs^Ft       , Gs^Ft       , Ss          , Gs^Ft       , Gs^Ft       , Hh          , Mm          , Mm          , Mm          , Mm          , Mm^Xm       , Mm          , Mm          , Hh          , Hh          , Gs^Ft       , Ss          , Gs^Ft       , Gs^Ft       , Re^Gvs      , Gs          , Dd          , Dd          , Mm          , Hh          , Gs          , Hh          , Hh          , Wo          , Wo          , Wo          , Chr         , Chr         , 4 Khr       , Gg          
Ww          , Ww          , Ww          , Ww          , Ww          , Ww          , Ww          , Gs^Ft       , Gs^Ft       , Gs^Ft       , Gs^Ft       , Gs^Ft       , Ss          , Mm          , Hh          , Hh          , Hh          , Mm          , Mm          , Mm          , Hh          , Gs^Ft       , Gs^Ft       , Gs^Ft       , Gs^Ft       , Re^Gvs      , Hh          , Hh          , Dd          , Rd          , Hh          , Hh          , Gs          , Ds          , Ww          , Wo          , Wo          , Wo          , Wo          , Chr         , Gg^Ve       , Gg          
Ww          , Ww          , Gs          , Ww          , Ww          , Ww          , Ww          , Ww          , Ww          , Gs^Ft       , Gs^Ft       , Ss          , Ss          , Ss          , Gs^Ft       , Gs^Ft       , Gs^Ft       , Hh          , Hh          , Mm          , Mm          , Hh          , Hh          , Gs^Ft       , Gs          , Re^Gvs      , Hh          , Hh          , Mm          , Dd          , Gs          , Gs          , Gs          , Ds          , Ww          , Wo          , Wo          , Wo          , Wo          , Wo          , Wo          , Gg          
Gs^Ft       , Gs          , Gs          , Gs          , Gs          , Ww          , Ww          , Ww          , Ww          , Ww          , Ww          , Ss          , Ss          , Ss          , Gs^Ft       , Gs^Ft       , Gs^Ft       , Gs^Ft       , Gs^Ft       , Mm          , Mm          , Mm          , Hh          , Gs          , Gs^Vht      , Re^Gvs      , Hh          , Dd          , Gs          , Gs          , Gs^Vht      , Gs          , Gs          , Ds          , Ds          , Ww          , Hh          , Wo          , Wo          , Wo          , Wo          , Wo          
Gs^Ft       , Gs          , Gs          , Gs          , Gs          , Gs          , Gs          , Ww          , Ww          , Ww          , Ww          , Ww          , Ww          , Ss          , Ww          , Ch          , Ch          , Gs^Ft       , Ch          , Ch          , Rp^Vhc      , Ch          , Gs          , Gs          , Gs          , Gs          , Gs          , Gs          , Dd          , Hh          , Dd          , Hh          , Hh          , Gs          , Gs          , Hh          , Re^Gvs      , Gs          , Gs          , Wo          , Wo          , Wo          
Gs^Ft       , Gs^Ft       , Gs          , Gs^Vht      , Gs          , Gs          , Gs          , Gs          , Gs          , Ww          , Ww          , Ww          , Ww          , Ww          , Ww^Bw/      , Rr          , Rr          , Kh          , Ch          , Ch          , Rr          , Ch          , Ch          , Gs          , Gs          , Gs          , Re^Gvs      , Hh          , Hh          , Rd          , Rd          , Mm          , Gs          , Gs          , Gs          , Gs          , Gs^Vht      , Hh          , Dd          , Gs          , Gs          , Wo          
Gs^Ft       , Gs^Ft       , Gs^Ft       , Gs          , Gs          , Gs          , Gs          , Gs          , Gs          , Gs          , Gs          , Ww          , Ww          , Ww          , Ww          , Ww^Bw/      , Rp^Vhc      , 1 Rr        , Rr          , Gg^Fet      , Rr          , Rp^Vhc      , Rr          , Rr          , Ch          , Gs          , Gs          , Mm          , Re^Gvs      , Hh          , Gs          , Gs          , Dd          , Gs          , Dd          , Gs          , Gs          , Hh          , Dd          , Dd          , Gs          , Gs          
Gs^Ft       , Gs^Ft       , Gs^Ft       , Gs^Ft       , Gs          , Gs          , Gs          , Gs          , Gs          , Gs          , Gs          , Gs^Ft       , Ss          , Ww          , Wwr         , Ch          , Rp^Vhc      , Rr          , Rp^Vhc      , Rr          , Ww          , Rr          , Rr          , Gg^Efm      , Rp^Vhc      , Ch          , Gs          , Gs          , Gs          , Gs          , Re^Gvs      , Hh          , Hd          , Dd          , Dd          , Dd          , Gs          , Hh          , Hh          , Dd          , Dd          , Gs          
Gs^Ft       , Gs^Ft       , Gs^Ft       , Gs^Ft       , Gs          , Gs          , Gs          , Gs          , Gs^Ft       , Gs          , Gs^Vht      , Gs^Ft       , Hh          , Gs^Ft       , Wwr         , Hh          , Hh          , Gs^Ft       , Gg^Efm      , Rr          , Rr          , Rr          , Rp^Vhc      , Rr          , Rr          , Ch          , Gs^Ft       , Gs          , Hh          , Gs          , Re^Gvs      , Hh          , Hh          , Hd          , Dd          , Dd          , Gs          , Re^Gvs      , Hh          , Dd          , Dd          , Gs          
Gs^Ft       , Ss          , Gs          , Gs          , Gs          , Gs          , Gs^Ft       , Gs^Ft       , Gs^Ft       , Gs^Ft       , Hh          , Hh          , Mm          , Mm          , Ww          , Mm          , Mm          , Ss          , Gs^Ft       , Rp^Vhc      , Gs^Ft       , Rr          , Ch          , Ch          , Gs          , Gs          , Hh          , Mm          , Mm          , Gs          , Gs^Vht      , Re^Gvs      , Re^Gvs      , Hh          , Hd          , Dd          , Gs          , Re^Gvs      , Re^Gvs      , Hh          , Gs          , Gs          
Gs^Ft       , Ss          , Gs          , Gs          , Gs          , Gs          , Gs^Ft       , Ss          , Gs^Ft       , Hh          , Mm          , Mm          , Ww          , Ww          , Wo          , Ww          , Ww          , Hh          , Hh          , Gs^Ft       , Gs^Ft       , Rp^Vhc      , Ch          , Gs          , Gs          , Gs          , Gs          , Mm          , Hh          , Gs          , Gs          , Gs          , Gs          , Hh          , Hh          , Dd          , Gs          , Gs          , Gs          , Gs^Vht      , Gs          , Gs          
Gs^Ft       , Gs^Ft       , Gs^Ft       , Gs          , Gs          , Ss          , Gs^Ft       , Gs^Ft       , Hh          , Hh          , Mm          , Mm          , Ww          , Wo          , Wo          , Wo          , Ww          , Mm          , Mm          , Hh          , Hh          , Mm          , Rd          , Gs          , Gs          , Gs^Vht      , Gs          , Gs          , Gs          , Gs          , Gs^Ft       , Gs          , Re^Gvs      , Gs          , Gs          , Gs          , Gs          , Gs          , Re^Gvs      , Gs          , Gs          , Gs          
Gs^Ft       , Gs^Ft       , Gs          , Gs          , Gs          , Gs^Ft       , Ss          , Ss          , Hh          , Mm          , Mm^Xm       , Mm^Xm       , Mm          , Ww          , Mm          , Mm^Xm       , Mm^Xm       , Mm          , Hh          , Hh          , Rd          , Rd          , Gs^Ft       , Gs          , Gs          , Gs          , Ds          , Ds          , Gs          , Gs          , Re^Gvs      , Re^Gvs      , Hh          , Mm          , Gs          , Gs          , Gs          , Re^Gvs      , Hh          , Hh          , Dd          , Gs          
Gs          , Gs          , Gs          , Gs          , Gs          , Gs^Ft       , Gs^Ft       , Ss          , Hh          , Mm          , Mm          , Mm          , Mm          , Ww          , Ww          , Mm          , Mm          , Mm          , Hh          , Rd          , Ss          , Gs^Ft       , Hh          , Gs^Ft       , Gs          , Ds          , Hh          , Gs          , Re^Gvs      , Re^Gvs      , Hh          , Hh          , Dd          , Dd          , Gs          , Gs          , Gs^Vht      , Re^Gvs      , Hh          , Hd          , Dd          , Gs          
Gs          , Gs          , Gs          , Gs          , Gs          , Chr         , Khr         , Gs^Ft       , Gs^Ft       , Hh          , Hh          , Hh          , Hh          , Hh          , Hh          , Ww          , Ww          , Hh          , Rd          , Rd          , Gs^Ft       , Gs^Ft       , Gs^Ft       , Gs^Ft       , Gs          , Gs          , Gs          , Gs          , Re^Gvs      , Gs^Vht      , Hh          , Hd          , Dd          , Dd          , Gs          , Gs          , Re^Gvs      , Re^Gvs      , Hh          , Hd          , Dd          , Gs          
Gs          , Gs          , Gs          , Gs          , Gs          , Chr         , Chr         , Gs^Ft       , Ss          , Gs^Ft       , Gs^Ft       , Ss          , Gs^Ft       , Hh          , Hh          , Gs^Ft       , Gs^Ft       , Ww          , Ww          , Gs^Ft       , Hh          , Mm          , Gs^Ft       , Gs^Ft       , Gs^Vht      , Gs          , Re^Gvs      , Re^Gvs      , Hh          , Hh          , Hd          , Hd          , Dd          , Gs          , Gs          , Gs          , Re^Gvs      , Hh          , Hd          , Hd          , Dd          , Gs          
Gs          , Gs          , Gs          , Ds          , Gs          , Gs          , Gs          , Gs^Ft       , Gs^Ft       , Gs^Ft       , Gs^Ft       , Gs^Ft       , Gs^Ft       , Gs^Ft       , Mm          , Gs^Ft       , Gs^Ft       , Gs^Ft       , Gs          , Ww          , Ww          , Hh          , Gs^Ft       , Gs^Ft       , Re^Gvs      , Re^Gvs      , Hh          , Hh          , Dd          , Dd          , Dd          , Dd          , Gs          , Gs          , Gs^Vht      , Gs          , Gs          , Hh          , Dd          , Dd          , Gs          , Gs          
Gs          , Gs          , Gs^Vht      , Gs          , Gs          , Gs          , Gs          , Gs          , Gs          , Gs          , Gs          , Gs          , Gs^Ft       , Hh          , Gs^Ft       , Hh          , Gs^Ft       , Gs          , Gs          , Gs          , Gs          , Ww          , Gs^Ft       , Re^Gvs      , Hh          , Hh          , Dd          , Dd          , Gs          , Gs          , Gs          , Gs          , Hh          , Hh          , Hh          , Hh          , Gs          , Gs          , Gs          , Dd          , Gs          , Gs          
Gs          , Gs          , Gs          , Gs          , Gs          , Gs          , Gs^Vht      , Gs          , Gs          , Gs          , Ds          , Gs          , Gs          , Gs^Ft       , Re^Gvs      , Re^Gvs      , Re^Gvs      , Re^Gvs      , Re^Gvs      , Gs^Vht      , Gs          , Ww          , Gs^Ft       , Hh          , Dd          , Dd          , Gs          , Gs          , Re^Gvs      , Gs^Vht      , Re^Gvs      , Hh          , Dd          , Dd          , Dd          , Dd          , Gs          , Ds          , Gs          , Gs          , Gs          , Gs          
Gs          , Gs          , Gs          , Gs          , Gs          , Re^Gvs      , Hh          , Re^Gvs      , Re^Gvs      , Gs          , Gs^Vht      , Gs          , Re^Gvs      , Re^Gvs      , Hh          , Mm          , Hh          , Hh          , Hh          , Re^Gvs      , Gs          , Ww          , Ss          , Gs          , Gs          , Gs          , Gs          , Re^Gvs      , Hh          , Hh          , Hh          , Hh          , Dd          , Dd          , Gs          , Gs          , Gs          , Gs          , Gs          , Gs          , Gs          , Gs          
Gs          , Gs          , Gs          , Gs          , Gs          , Hh          , Dd          , Hh          , Hh          , Re^Gvs      , Re^Gvs      , Gs          , Gs          , Hh          , Dd          , Hh          , Dd          , Hd          , Dd          , Hh          , Dd          , Gs          , Ss          , Ss          , Ss          , Ss          , Gs          , Hh          , Dd          , Dd          , Dd          , Dd          , Gs          , Dd          , Gs          , Gs          , Re^Gvs      , Re^Gvs      , Hh          , Gs          , Gs          , Gs          
Gs          , Gs          , Gs          , Gs          , Gs          , Gs          , Gs          , Dd          , Dd          , Hh          , Hh          , Re^Gvs      , Re^Gvs      , Gs          , Gs          , Dd          , Gs          , Dd          , Gs          , Dd          , Gs          , Gs          , Re^Gvs      , Ss          , Gs^Vht      , Re^Gvs      , Hh          , Gs          , Gs          , Dd          , Gs          , Gs          , Gs          , Gs^Vht      , Gs          , Gs          , Re^Gvs      , Hh          , Dd          , Gs          , Gs          , Gs          
Gs          , Gs          , Ce          , Ce          , Ce          , Gs          , Gs          , Gs          , Gs          , Dd          , Dd          , Hh          , Re^Gvs      , Gs          , Re^Gvs      , Gs          , Gs          , Gs          , Gs          , Gs          , Re^Gvs      , Re^Gvs      , Hh          , Mm          , Hh          , Hh          , Dd          , Gs          , Gs          , Gs          , Ds          , Ds          , Gs          , Gs          , Re^Gvs      , Re^Gvs      , Hh          , Hh          , Dd          , Gs          , Gs          , Gs          
Gs          , Gs          , Ce          , 3 Ke        , Ce          , Gs          , Gs^Vht      , Gs          , Dd          , Dd          , Mm          , Hh          , Hh          , Re^Gvs      , Hh          , Re^Gvs      , Gs          , Gs^Vht      , Gs          , Gs          , Hh          , Hh          , Hd          , Hh          , Hd          , Hd          , Dd          , Gs          , Hh          , Gs          , Gs          , Gs          , Hh          , Re^Gvs      , Hh          , Hh          , Dd          , Dd          , Gs          , Gs          , Gs          , Gs          
Gs          , Gs          , Re^Gvs      , Ce          , Re^Gvs      , Re^Gvs      , Re^Gvs      , Gs          , Dd          , Md          , Hd          , Hd          , Dd          , Hh          , Dd          , Hh          , Dd          , Gs          , Gs          , Gs          , Dd          , Hd          , Dd          , Hd          , Dd          , Dd          , Gs          , Rd          , Mm          , Hh          , Re^Gvs      , Hh          , Dd          , Hh          , Dd          , Dd          , Gs          , Gs          , Gs          , Gs          , Gs          , Gs          
Re^Gvs      , Re^Gvs      , Re^Gvs      , Gs^Vht      , Hh          , Hh          , Hh          , Gs          , Dd          , Dd          , Dd          , Dd          , Gs          , Dd          , Gs          , Dd          , Dd          , Gs          , Gs          , Gs          , Gs          , Dd          , Gs          , Dd          , Gs          , Gs          , Gs          , Gs^Ft       , Hh          , Gs^Vht      , Re^Gvs      , Hh          , Dd          , Dd          , Gs          , Gs          , Gs          , Gs          , Gs^Ft       , Gs          , Gs^Ft       , Gs          
Hh          , Hh          , Hh          , Hh          , Hh          , Dd          , Dd          , Gs          , Gs          , Gs          , Gs          , Gs          , Gs          , Gs          , Gs          , Gs          , Gs          , Gs          , Gs          , Gs          , Re^Gvs      , Gs          , Gs^Vht      , Gs          , Gs          , Gs          , Ds          , Gs          , Gs          , Gs          , Gs          , Hh          , Gs          , Gs          , Chr         , Gs^Ft       , Chr         , Gs^Ft       , Ss          , Gs^Ft       , Gs^Ft       , Gs          
Dd          , Dd          , Dd          , Dd          , Dd          , Dd          , Gs          , Gs          , Gs          , Gs          , Ds          , Gs          , Gs          , Gs^Vht      , Gs          , Gs          , Gs          , Gs          , Re^Gvs      , Re^Gvs      , Mm          , Re^Gvs      , Re^Gvs      , Gs          , Gs          , Gs          , Gs          , Ds          , Gs          , Gs          , Gs          , Gs          , Gs^Ft       , Chr         , Chr         , Chr         , Chr         , Ss          , Ss          , Gs^Ft       , Ss          , Gs          
Gs          , Gs          , Gs          , Dd          , Gs          , Gs          , Gs          , Gs^Vht      , Gs          , Gs          , Gs          , Gs          , Gs          , Gs          , Gs          , Gs          , Re^Gvs      , Re^Gvs      , Hh          , Hh          , Hd          , Hh          , Hh          , Re^Gvs      , Re^Gvs      , Gs          , Gs          , Gs          , Gs          , Gs          , Gs          , Gs^Ft       , Gs^Ft       , Ss          , Chr         , 2 Khr       , Chr         , Ss          , Ss          , Ss          , Gs          , Gs          
Gs          , Gs          , Gs          , Gs          , Ds          , Gs          , Gs          , Gs          , Ds          , Gs          , Gs          , Gs          , Gs          , Gs          , Gs          , Gs          , Hh          , Hh          , Dd          , Dd          , Dd          , Dd          , Dd          , Hh          , Hh          , Gs^Vht      , Gs          , Gs          , Gs          , Gs          , Gs          , Gs          , Gs          , Chr         , Chr         , Chr         , Ss          , Gs^Ft       , Gs^Ft       , Gs^Ft       , Gs          , Gs          
Gs          , Gs          , Gs^Vht      , Gs          , Gs          , Gs          , Gs          , Gs          , Gs          , Gs          , Gs          , Gs          , Gs          , Gs          , Gs          , Gs          , Gs          , Dd          , Gs          , Dd          , Gs          , Dd          , Gs          , Dd          , Gs          , Gs          , Gs          , Gs          , Gs          , Gs          , Gs          , Gs          , Gs          , Gs          , Gs^Ft       , Gs^Ft       , Ss          , Ss          , Ss          , Gs^Ft       , Gs^Ft       , Gs          
Gs          , Gs          , Gs          , Gs          , Gs          , Gs          , Gs          , Gs          , Gs          , Gs          , Gs          , Gs          , Gs          , Gs          , Gs          , Gs          , Gs          , Gs          , Gs          , Gs          , Gs          , Gs          , Gs          , Gs          , Gs          , Gs          , Gs          , Gs          , Gs          , Gs          , Gs          , Gs          , Gs          , Gs^Ft       , Gs^Ft       , Ss          , Ss          , Ss          , Gs          , Gs^Ft       , Gs          , Gs          
