Mm^Xm, Mm^Xm, Mm^Xm, Mm^Xm, Mm^Xm, Mm^Xm, Mm^Xm, Mm^Xm, Mm^Xm, Mm^Xm, Mm^Xm, Mm^Xm, Mm^Xm, Mm^Xm, Mm^Xm, Mm^Xm, Mm^Xm, Mm^Xm, Mm^Xm, Mm^Xm, Mm^Xm, Mm^Xm, Mm^Xm, Mm^Xm, Mm^Xm, Mm^Xm, Mm^Xm, Mm^Xm, Mm^Xm, Mm^Xm, Mm^Xm, Mm^Xm, Mm^Xm, Mm^Xm, Mm^Xm, Mm^Xm, Mm^Xm, Mm^Xm, Mm^Xm, Ww, Wo, Ww, Mm^Xm, Mm^Xm, Mm, Mm, Mm
Mm^Xm, Mm^Xm, Mm^Xm, Mm^Xm, Mm, Mm, Mm, Mm^Xm, Mm^Xm, Mm^Xm, Mm^Xm, Mm^Xm, Mm^Xm, Mm^Xm, Mm, Mm, Mm, Mm^Xm, Mm, Mm, Mm, Mm^Xm, Mm^Xm, Mm^Xm, Mm, Mm^Xm, Mm^Xm, Mm^Xm, Mm^Xm, Mm^Xm, Mm^Xm, Mm^Xm, Mm^Xm, Mm^Xm, Mm^Xm, Mm^Xm, Mm^Xm, Mm^Xm, Mm, Ww, Wo, Ww, Mm^Xm, Mm^Xm, Mm^Xm, Mm, Mm
Mm, Mm, Mm, Mm^Xm, Mm, Mm, Hh, Mm, Mm, Mm^Xm, Mm^Xm, Mm^Xm, Mm, Mm, Hh, Hh, Hh, Mm, Hh, Mm, Hh, Mm, Mm, Mm, Mm, Mm, Mm, Mm, Mm, Mm, Mm, Mm^Xm, Mm, Mm^Xm, Mm^Xm, Mm^Xm, Mm, Mm, Hh, Ww, Wo, Ww, Ww, Mm, Mm^Xm, Mm, Hh
Mm, Hh, Hh, Hh, Hh, Hh, Gs^Ft, Hh, Hh, Mm, Mm, Mm, Mm, Mm, Hh, Hh, Gs^Ft, Hh, Gs^Ft, Hh, Gs^Ft, Hh, Hh, Hh, Hh, Hh, Hh, Hh, Hh, Mm, Hh, Hh, Hh, Mm, Mm, Mm, Hh, Hh, Hh, Ww, Ww, Wo, Ww, Hh, 2 Mm^Xm, Hh, Gs
Hh, Hh, Hh, Hh, Gs^Ft, Gs^Ft, Gs^Ft, Gs^Ft, Gs^Ft, Hh, Hh, Hh, Hh, Hh, Gs^Ft, Gs^Ft, Gs^Ft, Gs^Ft, Gs^Ft, Gs^Ft, Gs, Gs^Ft, Gs, Gs, Gs, Hh, Gs, Gs, Gs, Hh, Ce, Ce, Ce, Hh, Hh, Hh, Dd, Dd, Dd, Dd, Ww, Wo, Ww, Hh, Hh, Hh, Gs
Hh, Hh, Gs^Ft, Gs^Ft, Gs^Ft, Gs^Ft, Gs, Gs^Ft, Gs, Gs^Ft, Gs, Hh, Gs, Gs^Ft, Gs, Gs^Ft, Gs, Gs, Gs, Gs, Gs, Gs, Gs, Gs, Gs, Gs, Gs, Gs, Gs, Gs, Ce, 1 Ke, Ce, Gs, Mm, Dd, Wwf, Dd, Wwf, Dd, Ww, Wo, Ww, Gs, Gs, Gs, Gs
Gs, Gs^Ft, Gs, Gs^Ft, Gs, Gs, Gs, Gs, Gs, Gs, Gs, Gs, Gs, Gs, Gs, Gs, Gs, Gs, Gs, Gs, Gs, Gs, Gs, Gs, Gs, Gs, Gs, Gs, Gs, Gs, Wwf, Ce, Wwf, Wwf, Wwf, Wwf, Ww, Wwf, Ww, Ww, Wwr, Wo, Ww, Ww, Ww, Gs, Gs
Gs, Gs, Gs, Gs, Gs, Gs, Re^Gvs, Gs^Vht, Re^Gvs, Gs, Gs, Gs, Gs, Gs, Gs, Gs, Gs, Gs, Gs, Gs, Gs, Gs, Ww, Ww, Ww, Gs, Ww, Gs, Ww, Wwf, Ww, Wwf, Ww, Ww, Ww, Ww, Wo, Ww, Wo, Ww, Wo, Wo, Wo, Ww, Ww, Ww, Ww
Gs, Gs, Gs, Gs, Re^Gvs, Re^Gvs, Re^Gvs, Re^Gvs, Re^Gvs, Re^Gvs, Re^Gvs, Gs, Gs, Gs, Gs, Gs, Gs, Gs, Gs, Gs, Ww, Ww, Wo, Wwr, Wo, Ww, Wo, Ww, Wo, Ww, Wo, Ww, Wwr, Wo, Wo, Wo, Wo, Wo, Wo, Wo, Wo, Wo, Wo, Wo, Wo, Wwr, Ww
Gs, Gs, Re^Gvs, Re^Gvs, Re^Gvs, Re^Gvs, Gg^Wm, Re^Gvs, Re^Gvs, Re^Gvs, Re^Gvs, Gs^Vht, Gs, Gs, Gs, Gs, Gs, Gs, Ww, Ww, Wo, Wo, Wo, Wo, Wo, Wo, Wo, Wo, Wo, Wo, Ww, Ww, Wwf, Ww, Ww, Ww, Ww, Wo, Ww, Wo, Ww, Wo, Wwr, Wo, Wo, Wo, Wo
Gs^Vht, Re^Gvs, Re^Gvs, Re^Gvs, Re^Gvs, Gg^Ve, Re^Gvs, Re^Gvs, Re^Gvs, Re^Gvs, Gs, Gs, Gs, Gs, Gs, Gs, Ww, Ww, Wo, Wo, Wo, Wo, Ww, Ww, Ww, Wo, Wo, Wo, Ww, Ww, Ds, Gs^Ft, Gs, Gs, Gs, Wwf, Wwf, Ww, Wwf, Ww, Wwf, Ww, Ww, Ww, Ww, Wo, Wo
Gs, Re^Gvs, Re^Gvs, Re^Gvs, Re^Gvs, Re^Gvs, Re^Gvs, Re^Gvs, Gs, Gs, Gs, Gs, Gs, Gs, Ww, Ww, Wo, Wo, Wo, Wo, Ww, Ww, Hh, Mm, Ds, Ww, Ww, Ww, Ds, Ds, Gs^Ft, Gs^Ft, Gs, Gs, Gs, Gs, Gs, Wwf, Gs, Wwf, Gs, Gs, Gs, Ww, Ww, Ww, Ww
Gs, Gs, Gs, Re^Gvs, Gs^Vht, Re^Gvs, Gs, Gs, Gs, Gs, Gs, Gs, Ww, Ww, Wo, Wo, Wo, Wo, Ww, Ww, Gs, Gs, Gs, Hh, Gs, Ds, Ds, Ds, Gs, Gs^Ft, Gs, Gs, Gs, Gs, Gs^Ft, Gs, Gs, Gs, Gs, Gs, Gs, Gs, Gs, Gs, Gs, Ww, Ww
Gs, Gs, Gs, Gs, Gs, Gs, Gs, Gs, Gs, Gs, Ww, Ww, Wo, Wo, Wo, Wo, Ww, Ww, Gs, Gs, Gs, Gs, Gs, Gs, Gs, Gs, Gs, Gs, Gs, Gs, Gs, Gs, Gs^Ft, Gs^Ft, Gs^Ft, Gs^Ft, Gs^Ft, Gs^Ft, Gs^Ft, Gs^Ft, Gs^Ft, Gs^Ft, Gs^Ft, Gs^Ft, Gs^Ft, Gs, Gs^Ft
Gs, Gs, Gs, Gs, Gs, Gs, Gs, Gs, Ww, Ww, Wo, Wo, Wo, Wo, Ww, Ww, Gs, Gs, Gs, Gs, Gs, Gs^Ft, Gs^Ft, Gs, Rd, Gs, Gs, Gs, Gs, Gs, Re, Gs^Ft, Gs^Ft, Gs^Ft, Hh, Gs^Ft, Gs^Ft, Gs^Ft, Gs^Ft, Gs^Ft, Gs^Ft, Gs^Ft, Gs^Ft, Gs^Ft, Gs^Ft, Gs^Ft, Gs^Ft
Gs, Gs, Gs, Gs, Gs, Gs, Ww, Ww, Wo, Wo, Wo, Wo, Ww, Ww, Gs, Gs, Gs, Gs, Gs, Gs, Gs^Ft, Gs^Ft, Rd, Rd, Gs^Ft, Gs^Ft, Gs^Ft, Gs^Vht, Gs^Ft, Gs^Ft, Re, Gs^Ft, Gs^Ft, Gs^Ft, Gs^Ft, Gs^Ft, Gs^Ft, Gs^Ft, Gs^Ft, Gs^Ft, Gs^Ft, Gs^Ft, Gs^Ft, Gs^Ft, Gs^Ft, Gs^Ft, Gs^Ft
Gs, Gs, Gs, Gs, Wwf, Wwf, Wwf, Ww, Ww, Wo, Ww, Ww, Gs, Gs, Gs, Gs, Gs, Gs, Gs, Gs, Rd, Rd, Gs^Ft, Gs^Ft, Hh, Gs^Ft, Hh, Gs^Ft, Gs^Ft, Gs^Ft, Re, Gs^Ft, Hh, Gs^Ft, Gs^Ft, Gs^Ft, Gs^Ft, Gs^Ft, Gs^Ft, Gs^Ft, Mm, Hh, Gs^Ft, Gs^Ft, Gs^Ft, Gs^Ft, Gs^Ft
Gs, Gs, Gs, Gs, Wwf, Wwf, Wwf, Wwf, Wwf, Ww, Gs, Gs, Gs, Gs, Rd, Mm^Xm, Gs, Gs, Gs^Ft, Gs, Gs^Ft, Gs^Ft, Gs^Ft, Gs^Ft, Hh, Hh, Mm, Hh, Mm, Gs^Ft, Gs^Ft, Gs^Ft, Hh, Gs^Ft, Hh, Hh, Gs^Ft, Gs^Ft, Gs^Ft, Gs^Ft, Hh, Hh, Hh, Gs^Ft, Gs^Ft, Gs^Ft, Gs^Ft
Gs, Gs, Gs, Wwf, Wwr, Wwf, Wwf, Wwr, Wwf, Gs, Gs, Gs, Rd, Rd, Gs, Gs, Gs^Ft, Gs^Ft, Gs^Ft, Ww, Ww, Ww, Ww, Hh, Mm, Mm, Hh, Hh, Hh, Hh, Gs^Ft, Gs^Ft, Gs^Ft, Hh, Gs^Ft, Mm, Gs^Ft, Gs^Ft, Hh, Hh, Gs^Ft, Gs^Ft, Gs^Ft, Gs^Ft, Gs^Ft, Gs^Ft, Gs^Ft
Gs, Gs, Gs, Wwf, Ww, Wwf, Wwf, Wwf, Gs, Gs, Rd, Rd, Gs, Gs, Gs, Gs, Gs^Ft, Gs^Ft, Ww, Wo, Wo, Wo, Ww, Mm, Hh, Hh, Gs^Ft, Gs^Ft, Re, Gs^Ft, Gs^Ft, Mm, Gs^Ft, Gs^Ft, Gs^Ft, Gs^Ft, Gs^Ft, Gs^Ft, Hh, Gs^Ft, Gs^Ft, Gs^Ft, Gs^Ft, Gs^Ft, Hh, Gs^Ft, Gs^Ft
Gs^Ft, Gs, Gs, Ds, Ww, Ww, Ww, Wwf, Gs, Rd, Rd, Gs^Ft, Gs, Gs, Gs, Gs^Ft, Gs^Ft, Gs^Ft, Ww, Wo, Wo, Wo, Wo, Ww, Re, Re, Re, Re, Gs^Ft, Gs^Ft, Mm, Mm, Gs^Ft, Hh, Hh, Hh, Hh, Hh, Re^Uf, Hh, Hh, Gs^Ft, Gs^Ft, Gs^Ft, Hh, Gs^Ft, Gs^Ft
Gs^Ft, Gs, Gs, Ds, Ww, Wo, Ww, Wwf, Gs, Gs, Gs, Rd, Gs, Gs, Gs, Gs^Ft, Gs^Ft, Hh, Ww, Wo, Wo, Wo, Ww, Ww, Re, Hh, Hh, Hh, Hh, Gs^Ft, Mm, Hh, Hh, Gs^Ft, Hh, Hh, Re^Uf, Re^Uf, Gg^Efm, Re^Uf, Re^Uf, Hh, Hh, Gs^Ft, Hh, Gs^Ft, Gs^Ft
Gs^Ft, Gs, Gs, Ds, Ww, Wo, Wwf, Ww, Ww, Gs, Gs, Rd, Rd, Gs, Gs, Gs^Ft, Gs^Ft, Gs^Ft, Re, Ww, Re, Ww, Wwr, Ww, Re, Gs^Ft, Hh, Hh, Hh, Gs^Ft, Gs^Ft, Gs^Ft, Hh, Gs^Ft, Hh, Re^Uf, Gg^Efm, Gg^Efm, Gg^Efm, Gg^Efm, Gg^Efm, Re^Uf, Hh, Gs^Ft, Hh, Gs^Ft, Gs^Ft
Gs, Gs, Gs, Ds, Ds, Ww, Wwf, Wwf, Ww, Ww, Ww, Gs, Gs, Rd, Gs, Gs, Gs^Ft, Gs^Ft, Gs^Ft, Re, Gs^Ft, Gs^Ft, Gs^Ft, Gs^Ft, Re, Hh^Vhh, Gs^Ft, Gs^Ft, Gs^Ft, Gs^Ft, Gs^Ft, Hh, Gs^Ft, Gs^Ft, Hh, Re^Uf, Gg^Efm, Gg^Efm, Ai, Gg^Efm, Gg^Efm, Re^Uf, Hh, Gs^Ft, Gs^Ft, Gs^Ft, Gs^Ft
Gs, Gs, Gs, Gs^Vht, Hh, Ww, Ww, Wo, Wo, Ww, Ww, Ww, Gs, Rd, Gs, Gs^Vht, Gs^Ft, Gs^Ft, Gs^Ft, Hh, Hh, Gs^Ft, Gs^Ft, Gs^Ft, Gs^Ft, Re, Re, Gs^Ft, Hh, Gs^Ft, Gs^Ft, Gs^Ft, Mm, Mm, Hh, Re^Uf, Gg^Efm, Gg^Efm, Gg^Efm, Gg^Efm, Gg^Efm, Re^Uf, Hh, Gs^Ft, Gs^Ft, Gs^Ft, Gs^Ft
Gs, Gs, Gs, Hh, Gs, Hh, Ww, Wo, Wo, Wo, Ww, Ww, Gs, Rd, Gs^Ft, Gs^Ft, Gs^Ft, Gs^Ft, Gs^Ft, Hh, Gs^Ft, Hh, Gs^Ft, Gs^Ft, Gs^Ft, Gs^Ft, Re, Hh, Gs^Ft, Hh, Hh, Gs^Ft, Mm, Mm, Hh, Re^Uf, Re^Uf, Gg^Efm, Gg^Efm, Gg^Efm, Re^Uf, Re^Uf, Hh, Gs^Ft, Gs^Ft, Gs^Ft, Gs^Ft
Gs, Gs, Gs, Gs, Gs, Ds, Ww, Wwr, Wo, Wo, Ww, Ww, Gs, Rd, Gs^Ft, Gs^Ft, Gs^Ft, Gs^Ft, Gs^Ft, Gs^Ft, Gs^Ft, Hh, Gs^Ft, Gs^Ft, Rd, Gs^Ft, Gs^Ft, Re, Re, Gs^Ft, Gs^Ft, Gs^Ft, Gs^Ft, Mm, Rd, Hh, Hh, Re^Uf, Re^Uf, Re^Uf, Hh, Hh, Gs^Ft, Gs^Ft, Gs^Ft, Gs^Ft, Gs^Ft
Gs, Gs, Gs, Gs, Gs, Ds, Ww, Ww, Wo, Wo, Ww, Ww, Gs, Rd, Gs, Gs^Ft, Gs, Hh, Hh, Gs^Ft, Gs^Ft, Gs^Ft, Gs^Ft, Gs^Ft, Rd, Gs^Ft, Gs^Ft, Hh, Hh, Re, Re, Gs^Ft, Gs^Ft, Rd, Mm, Gs^Ft, Gs^Ft, Hh, Hh, Hh, Gs^Ft, Gs^Ft, Gs^Ft, Gs^Ft, Gs^Ft, Gs^Ft, Gs^Ft
Gs, Gs, Gs, Gs, Gs, Ds, Ww, Ww, Wo, Wo, Ww, Ww, Gs, Rd, Rd, Gs, Gs, Gs, Gs, Hh, Hh, Gs^Ft, Gs^Ft, Gs^Ft, Gs^Ft, Gs^Ft, Gs^Ft, Hh, Hh, Gs^Ft, Gs^Ft, Re, Re, Gs^Ft, Hh, Mm, Mm, Gs^Ft, Gs^Ft, Gs^Ft, Gs^Ft, Gs^Ft, Gs^Ft, Gs^Ft, Gs^Ft, Gs^Ft, Gs^Ft
Gs^Ft, Gs, Gs, Gs, Hh, Hh, Ww, Ww, Ww, Ww, Wwr, Wwr, Gs, Gs, Rd, Gs, Gs, Gs, Gs, Gs, Gs, Gs, Gs, Gs^Ft, Gs^Ft, Gs^Ft, Gs^Ft, Gs^Ft, Gs^Ft, Hh, Hh, Gs^Ft, Re, Gs^Ft, Gs^Ft, Hh, Gs^Ft, Gs^Ft, Gs^Ft, Gs^Ft, Hh, Gs^Ft, Gs^Ft, Gs^Ft, Gs^Ft, Gs^Ft, Gs^Ft
Gs^Ft, Gs^Ft, Gs, Gs, Gs, Ww, Ww, Wo, Ww, Wwr, Gs, Gs, Rd, Rd, Gs, Rd, Rd, Rd, Gs, Gs, Gs, Gs, Gs, Gs^Ft, Mm, Hh, Hh, Hh, Mm, Gs^Ft, Gs^Ft, Gs^Ft, Re, Gs^Ft, Hh, Hh, Gs^Ft, Gs^Ft, Gs^Ft, Hh, Gg^Vh, Hh, Hh, Gs^Ft, Gs^Ft, Gs^Ft, Gs^Ft
Gs, Gs, Gs, Gs, Ww, Ww, Wo, Wo, Ww, Wwr, Gs, Gs, Gs, Gs, Gs, Gs, Gs, Gs, Gs, Gs, Gs, Gs, Gs, Hh, Hh, Mm, Hh, Mm, Hh, Hh, Gs^Ft, Re, Hh, Hh, Gs^Ft, Gs^Ft, Gs^Ft, Gs^Ft, Gs^Ft, Hh, Gs^Ft, Gs^Ft, Gs^Ft, Gs^Ft, Gs^Ft, Gs^Ft, Gs^Ft
Gs, Gs, Gs, Gs, Ww, Wo, Wo, Wo, Ww, Wwf, Wwf, Gs, Wwf, Gs, Gs, Gs, Gs^Vht, Gs, Gs, Gs, Gs, Gs, Gs, Gs^Ft, Gs^Ft, Hh, Gs^Ft, Hh, Gs^Ft, Gs^Ft, Gs^Ft, Re, Re, Hh, Gs^Ft, Gs^Ft, Gs^Ft, Gs^Ft, Gs^Ft, Gs^Ft, Gs^Ft, Gs^Ft, Gs^Ft, Gs^Ft, Gs^Ft, Gs^Ft, Gs^Ft
Gs, Gs, Gs, Gs, Ww, Wo, Wo, Wo, Ww, Wwf, Wwf, Wwf, Ww, Wwf, Wwf, Gs, Gs, Gs, Gs^Ft, Gs, Gs, Gs, Gs, Gs, Gs, Gs^Ft, Gs, Gs^Ft, Gs^Ft, Gs^Ft, Gs^Ft, Gs^Ft, Gs^Ft, Re, Gs^Ft, Gs^Ft, Gs^Ft, Gs^Ft, Gs^Ft, Gs^Ft, Gs^Ft, Gs^Ft, Gs^Ft, Gs^Ft, Gs^Ft, Gs^Ft, Gs^Ft
Gs, Gs, Gs, Gs, Gs, Ww, Ww, Ww, Wwf, Wwf, Wwf, Ww, Wo, Ww, Ww, Ww, Ww, Gs, Gs, Gs, Gs, Gs, Gs, Gs, Gs, Gs, Gs, Gs, Gs, Gs^Ft, Gs, Gs^Ft, Gs, Gs, Gs, Gs^Ft, Gs^Ft, Gs^Ft, Gs^Ft, Gs^Ft, Gs^Ft, Gs^Ft, Gs^Ft, Gs^Ft, Gs^Ft, Gs^Ft, Gs^Ft
Gs^Ft, Gs^Ft, Gs^Ft, Gs, Gs, Gs, Gs, Gs, Gs, Wwf, Ww, Ww, Wo, Wo, Wo, Ww, Wo, Ww, Ww, Gs, Gs, Gs, Gs, Gs, Gs, Gs, Gs, Gs, Gs, Gs, Gs, Gs, Gs, Gs, Gs, Gs, Gs, Gs, Gs, Gs, Gs, Gs^Ft, Gs^Ft, Gs^Ft, Gs^Ft, Gs^Ft, Gs^Ft
Gs^Ft, Gs^Ft, Gs^Ft, Gs^Ft, Gs^Ft, Gs, Gs, Rd, Gs, Gs, Gs, Ww, Ww, Wo, Wo, Wo, Wo, Wo, Wo, Ww, Gs^Ft, Gs, Gs, Gs, Ds, Gs, Ds, Gs, Gs, Gs, Gs, Gs, Gs, Gs, Gs, Gs, Gs, Gs, Gs, Gs, Gs, Gs^Ft, Gs^Ft, Gs^Ft, Gs^Ft, Gs^Ft, Gs^Ft
Gs^Ft, Gs^Ft, Gs^Ft, Gs^Ft, Gs^Ft, Gs, Rd, Rd, Gs, Gs, Gs^Ft, Gs, Gs, Ww, Ww, Wo, Wwr, Wo, Wo, Ww, Mm, Hh, Rd, Hh, Ha, Ds, Hh, Ds, Ds, Ds, Gs, Gs, Gs, Gs^Ft, Gs, Gs, Gs, Gg^Fet, Gs, Gs, Gs, Gs, Gs, Gs^Ft, Gs, Gs^Ft, Gs^Ft
Gs^Ft, Gs^Ft, Gs^Ft, Gs^Ft, Cer, Gs, Rd, Gs, Gs^Ft, Gs^Ft, Hh, Hh, Gs, Gs, Gs, Ww, Ww, Wo, Wo, Ww, Mm, Mm, Rd, Mm, Ha, Ha, Mm, Hh, Hh, Ds, Gs, Gs, Gs, Gs, Gs, Gs, Rd, Rd, Gs, Gs, Gs, Gs, Hh, Gs, Gs, Gs^Ft, Gs^Ft
Gs^Ft, Gs^Ft, Gs^Ft, Cer, Gs^Vht, Cer, Rd, Gs^Vht, Hh, Hh, Mm, Ss, Ds, Gs, Gs, Ww, Ww, Wo, Wo, Ww, Ww, Wwf, Mm, Mm, Wwf, Mm, Mm, Mm, Hh, Hh, Gs^Ft, Gs, Gs, Gs^Vht, Gs, Gs, Gs^Ft, Rd, Rd, Gs, Gs, Hh, Hh, Hh, Hh, Gs, Gs
Gs^Ft, Gs^Ft, Gs^Vht, Cer, 3 Ker, Gs, Rd, Gs^Ft, Gs^Ft, Hh, Gs^Ft, Ss, Ss, Gs, Gs, Ww, Ww, Wo, Wo, Ww, Ww, Wwf, Wwf, Wwf, Ww, Ww, Ww, Ww, Ww, Ww, Ww, Gs, Gs, Gs, Gs, Hh, Gs^Ft, Gs^Ft, Gs, Rd, Gs, Hh, Gs, Hh, Hh, Hh, Gs
Gs^Ft, Gs^Ft, Gs, Gs, Ker, Rd, Gs^Vht, Gs, Gs^Ft, Hh, Hh, Gs^Ft, Gs^Ft, Ss, Gs^Ft, Ww, Ww, Wo, Wo, Wo, Wo, Ww, Ww, Ww, Wo, Wo, Wo, Ww, Wo, Ww, Wwr, Ww, Ww, Gs, Gs, Gs, Gs, Gs, Gs, Rd, Gs, Gs, Gs, Gs, Gs, Gs, Gs
Gs^Ft, Gs^Ft, Gs, Gs, Gs^Vht, Cer, Gs, Gs, Gs^Ft, Mm, Hh, Hh, Gs^Ft, Gs^Ft, Gs^Ft, Gs^Ft, Gs^Ft, Ww, Ww, Wo, Ww, Ww, Wwf, Ww, Ww, Wo, Wo, Wo, Wo, Wo, Wo, Ww, Ww, Gs, Gs, Gs, Hh, Gs, Gs, Gs, Gs, Gs, Gs, Gs^Vht, Gs, Gs, Hh
Gs, Gs^Vht, Gs, Cer, Cer, Cer, Gs, Gs, Gs, Gs^Ft, Hh, Gs^Ft, Ss, Gs^Ft, Gs^Ft, Gs^Ft, Ss, Gs^Ft, Gs^Ft, Ww, Wwf, Wwf, Gs^Ft, Wwf, Wwf, Ww, Ww, Wo, Wo, Wo, Wo, Wo, Wo, Ww, Ww, Gs, Gs, Hh, Gs, Gs, Gs, Gs, Gs, Gs, Gs, Hh, Hh
Gs, Gs, Gs^Ft, Gs, Gs, Gs, Re^Gvs, Re^Gvs, Re^Gvs, Gs, Gs, Gs, Gs, Gs^Ft, Ds, Ss, Re, Re, Ds, Gs^Ft, Gs^Ft, Gs^Ft, Gs^Ft, Gs^Ft, Gs, Gs, Gs, Ww, Ww, Wwr, Ww, Wo, Wo, Wo, Wo, Ww, Ww, Gs, Gs, Gs, Gs, Gs, Gs, Gs, Hh, Hh, Hh
Gs^Ft, Gs^Ft, Ss, Gs^Ft, Gs^Ft, Gs, Re^Gvs, Re^Gvs, Re^Gvs, Re^Gvs, Re^Gvs, Gs, Gs, Gs^Ft, Ds, Ss, Gs^Ft, Ss, Gs^Ft, Gs^Ft, Gs^Ft, Re, Gs^Ft, Gs^Ft, Gs, Gs, Gs, Gs, Gs, Ww, Ww, Ww, Wwr, Wo, Wo, Ww, Ww, Gs, Gs, Gs, Chr, Gs, Chr, Gs, Gs, Hh, Hh
Gs^Ft, Gs^Ft, Ss, Hh, Gs^Ft, Gs, Gs^Ft, Re^Gvs, Re^Gvs, Re^Gvs, Re^Gvs, Re^Gvs, Gg^Wm, Gs^Ft, Gs^Ft, Ss, Ss, Ss, Re, Gs^Ft, Gs^Ft, Gs^Ft, Gs, Gs, Dd, Dd, Dd, Gs, Gs, Gs, Gs, Ww, Ww, Wo, Wo, Wwr, Ww, Chr, Chr, Gs, Gs, Chr, Rp, Chr, Gs, Gs, Gs
Gs^Ft, Hh, Hh, Ss, Ss, Gs^Ft, Gs^Ft, Gs^Ft, Gs, Re^Gvs, Re^Gvs, Re^Gvs, Gs, Gs^Ft, Gs^Ft, Gs^Ft, Gs^Ft, Ss^Vhs, Gs^Ft, Gs^Ft, Gs, Gs, Gs, Gs, Dd, Dd^Dc, Dd, Rd, Gs, Gs, Gs, Chr, Ww, Wo, Wo, Wo, Wo, Ww, Ds, Dd^Dr, Rp, Rp, Rp, Chr, Gs, Gs, Gs
Gs^Ft, Gs^Ft, Gs^Ft, Gs^Ft, Ss, Hh, Gs^Ft, Gs^Ft, Gs, Gs, Gs, Gs, Gs, Gs^Ft, Gs^Ft, Ss, Ss, Gs^Ft, Gs^Ft, Gs, Gs, Gs, Gs, Gs, Rd, Dd, Dd, Rd, Gs, Gs, Rp, Rp, Rp, Ww, Ww, Wo, Wo, Ww, Ww, Gs^Ft, Rp, Chr, Chr, Rp, Ds, Gs, Gs
Ss, Gs^Ft, Gs^Ft, Ss, Gs^Ft, Gs^Ft, Gs^Ft, Ss^Vhs, Gs, Gs, Gs, Gs, Gs^Ft, Gs, Gs^Ft, Gs^Ft, Hh, Gs^Ft, Gs^Ft, Gs, Gs, Gs, Gs, Dd, Dd, Rd, Gs, Gs, Chr, Chr, Dd^Dr, Gs^Ft, Gs, Chr, Ds, Ww, Wo, Wo, Wo, Ww, Rp, Chr, Chr, Rp, Gs, Gs, Gs
Ss, Ss, Ss, Gs^Ft, Gs^Ft, Mm, Hh, Gs, Re, Re, Re, Re, Re, Re, Ss, Ss, Ss, Gs^Ft, Gs^Ft, Gs^Ft, Gs, Gs, Gs, Dd, Gs, Gs, Gs, Gs, Gs, Chr, Rp, Chr, Rp, Gs, Gs, Ww, Wo, Wo, Ww, Ww, Gs, Rp, Rp, Chr, Gs, Gs, Gs
Gs^Ft, Gs^Ft, Ss, Ss, Ss, Gs^Ft, Gs^Ft, Re, Gs^Ft, Gs^Ft, Gs^Ft, Gs^Ft, Gs^Ft, Ss^Bw\, Re, Ss, Gs^Ft, Re, Gs^Ft, Gs^Ft, Gs, Gs, Mm^Xm, Gs, Gs, Gs, Dd, Rd, Dd, Gs, Gs^Ft, Rp, Dd^Dr, Rp, Gs, Ww, Ww, Ww, Wwf, Ww, Wwf, Gs, Gs, 4 Khr, Gs, Gs, Gs
Gs^Ft, Gs^Ft, Gs^Ft, Ss, Gs^Ft, Ss, Ss, Gs^Ft, Ss, Re, Ss, Ds, Ss, Ss, Ss, Rd, Ss, Re, Gs^Ft, Gs^Ft, Gs, Mm^Xm, Mm^Xm, Mm^Xm, Gs, Rd, Dd, Dd^Dr, Dd, Gs, Gs, Rp, Gs^Ft, Rp, Rp, Gs, Gs, Wwf, Wwf, Wwf, Wwf, Wwf, Gs, Chr, Gs, Gs, Gs
Ds, Gs^Ft, Gs^Ft, Gs^Ft, Gs^Ft, Gs^Ft, Ss, Ds, Ss, Gs^Ft, Ds, Ss, Re, Gs^Ft, Ss, Rd, Ss, Ds, Gs^Ft, Gs^Ft, Gs, Mm^Xm, Mm^Xm, Mm^Xm, Gs, Rd, Dd, Dd, Rd, Gs, Chr, Rp, Gs, Gs, Gs, Gs, Gs, Wwf, Wwf, Ww, Ww, Wwf, Ww, Gs, Gs, Gs, Gs
Ww, Ds, Ds, Gs^Ft, Ds, Gs^Ft, Ww, Ss, Ss, Ss, Ss, Hh, Ss, Ss, Gs^Ft, Ss^Bw|, Gs^Ft, Gs^Ft, Gs, Gs^Ft, Gs, Gs, Gs, Gs, Gs, Gs, Gs, Rd, Gs, Gs, Gs, Gs, Hh, Hh, Hh, Hh, Hh, Gs, Gs, Chw, Ww, Ww, Chw, Ww, Ww, Gs, Gs
Ds, Ww, Ww, Ds, Ds, Gs^Ft, Ww, Ww, Gs^Ft, Ds, Ss^Vhs, Ss, Re, Gs^Ft, Re, Re, Gs, Gs, Hh, Gs, Hh, Hh, Hh, Hh, Gs, Gs, Gs, Gs, Gs, Gs, Gs, Gs, Gs, Hh, Chr, Rp, Rp, Gs, Gs, Gs, Ww, Wo, Wo, Ww, Ww, Gs, Gs
Hh, Ds, Ds, Ww, Ww, Gs^Ft, Ww, Ww, Gs^Ft, Gs^Ft, Gs^Ft, Re, Re, Re, Gs, Gs, Hh, Hh, Hh, Rd, Rd, Hh, Hh, Hh, Hh, Hh, Gs, Gs, Gs, Gs, Gs, Gs, Gs, Gs, Gs, Chr, Chr, Chr, Gs, Gs, Gs, Ww, Ww, Wwr, Wo, Ww, Gs
Hh, Ds, Ds, Ds, Ds, Ww, Ww, Ww, Gs, Gs, Gs, Gs, Hh, Hh, Hh, Hh, Hh, Hh, Rd, Rd, Hh, Rd, Hh, Hh, Rd, Hh, Hh, Hh, Hh, Gs, Hh, Gs, Gs, Gs, Gs, Gs, Gs, Gs, Gs, Gs, Gs, Ww, Wo, Wo, Wo, Ww, Gs
Mm, Hh, Hh, Hh, Hh, Ds, Ww, Ww, Gs, Gs, Gs, Hh, Hh, Mm, Hh, Hh, Rd, Hh, Hh, Hh, Hh, Rd, Rd, Rd, Mm, Mm, Mm, Mm, Hh, Hh, Hh, Hh, Hh, Gs, Gs, Gs, Gs, Mm, Gs, Gs, Gs, Ww, Ww, Wo, Wo, Ww, Gs
Mm^Xm, Mm, Mm, Mm, Mm, Hh, Ww, Ww, Hh, Hh, Rd, Hh, Rd, Hh, Rd, Rd, Rd, Hh, Hh, Gs^Ft, Rd, Rd, Rd, Hh, Mm, Ha, Mm, Hh, Rd, Hh, Hh, Hh, Hh, Gs, Gs, Gs, Gs, Gs, Gs, Gs, Wwf, Wwf, Wwf, Ww, Ww, Ww, Gs
Mm^Xm, Mm^Xm, Mm^Xm, Mm^Xm, Mm, Hh, Ww, Ww, Hh, Hh, Gs^Ft, Rd, Hh, Rd, Hh, Hh, Rd, Rd, Hh, Hh, Rd, Rd, Gs^Ft, Hh, Mm, Mm, Rd, Rd, Hh, Hh, Hh^Vhh, Hh, Hh, Gs, Gs, Gs, Gs, Gs, Gs, Ww, Ww, Wwf, Wwf, Wwf, Gs, Gs, Gs
Ww, Ww, Ww, Mm, Ww, Ww, Ww, Ww, Rd, Hh, Hh, Hh, Hh, Gs^Ft, Hh, Hh, Rd, Rd, Hh, Hh, Rd, Rd, Gs^Ft, Hh, Hh, Hh, Rd, Hh, Mm, Mm, Mm, Hh, Hh, Hh, Hh, Gs, Gs, Gs, Gs, Ww, Ww, Ww, Ww, Wwf, Gs, Gs, Hh
Ww, Ww, Ww, Ww, Ww, Ww, Hh, Rd, Hh, Gs^Ft, Hh, Rd, Hh, Hh, Gs^Ft, Rd, Rd, Hh, Hh, Hh, Hh, Rd, Hh, Hh, Hh, Hh, Rd, Hh, Mm, Ha, Ha, Mm, Mm, Mm, Hh, Rd, Rd, Gs, Gs, Ww, Wo, Wo, Ww, Wwr, Gs, Hh, Mm
Mm^Xm, Mm^Xm, Mm, Ww, Hh, Hh, Gs^Ft, Rd, Hh, Mm, Hh, Rd, Hh, Hh, Hh, Rd, Hh, Rd, Rd, Gs^Ft, Hh, Rd, Rd, Hh, Hh, Gs^Ft, Hh, Rd, Rd, Mm, Ha, Ha, Ha, Ha, Hh, Gs, Rd, Gs, Wwf, Ww, Wo, Wo, Ww, Wwf, Gs, Hh, Hh
Mm^Xm, Mm, Mm, Mm, Mm, Hh, Hh, Rd, Rd, Hh, Hh, Rd, Hh, Hh, Mm, Hh, Gs^Ft, Hh, Rd, Hh, Mm, Hh, Rd, Hh, Hh, Mm, Hh, Rd, Rd, Mm, Mm, Ha, Mm, Mm, Gs, Gs, Rd, Gs, Wwf, Ww, Ww, Wo, Ww, Wwf, Gs, Gs, Gs
Mm^Xm, Mm^Xm, Mm, Mm, Mm, Mm, Hh, Hh, Rd, Gs^Ft, Rd, Rd, Hh, Mm, Mm, Mm, Hh, Rd, Rd, Hh, Hh, Hh, Rd, Rd, Rd, Hh, Rd, Rd, Hh, Rd, Hh, Mm, Hh, Gs, Gs, Gs, Gs, Gs, Wwf, Ww, Ww, Ww, Hh, Hh, Gs, Gs, Gs
Mm, Mm, Mm, Mm, Hh, Hh, Rd, Rd, Hh, Hh, Rd, Hh, Gs^Ft, Hh, Hh, Hh, Rd, Rd, Hh, Rd, Rd, Rd, Rd, Rd, Rd, Rd, Hh, Hh, Hh, Rd, Hh, Hh, Hh, Rd, Hh, Gs, Gs, Gs, Ww, Ww, Wo, Ww, Ww, Mm, Gs, Gs, Gs
Mm, Mm, Hh, Hh, Gs^Ft, Rd, Rd, Gs^Ft, Hh, Gs^Ft, Gs^Ft, Rd, Rd, Rd, Rd, Rd, Hh, Hh, Mm, Hh, Hh, Hh, Hh, Hh, Rd, Hh, Mm, Hh, Hh, Hh, Gs^Ft, Hh, Gs, Hh, Gs, Gs, Gs, Gs, Gs, Ww, Wo, Ww, Ww, Hh, Gs, Gs, Gs
Hh, Hh, Hh, Hh, Rd, Rd, Rd, Hh, Gs^Ft, Hh, Hh, Hh, Rd, Hh, Hh, Hh, Hh, Hh, Hh, Hh, Hh, Mm, Hh, Hh, Rd, Hh, Hh, Hh, Gs^Ft, Gs^Ft, Gs^Ft, Gs, Gs, Gs, Gs, Gs, Gs, Gs, Gs^Vht, Ww, Ww, Wo, Ww, Ww, Gs, Gs, Hh
Hh, Hh, Hh, Hh^Vhh, Hh, Hh, Rd, Rd, Rd, Rd, Rd, Hh, Rd, Hh, Gs^Ft, Hh, Gs^Ft, Gs^Ft, Gs^Ft, Hh, Rd, Hh, Rd, Rd, Hh, Hh, Gs^Ft, Gs^Ft, Gs^Ft, Gs, Gs, Gs, Gs, Gs, Gs, Gs, Gs, Gs, Wwf, Ww, Ww, Wo, Ww, Ww, Gs, Hh^Vhh, Gs^Ft
Hh, Hh, Hh, Hh, Hh, Gs^Ft, Gs^Ft, Hh, Hh, Hh, Rd, Rd, Hh, Rd, Rd, Gs^Ft, Gs^Ft, Gs^Ft, Hh, Rd, Hh, Rd, Hh, Hh, Hh, Gs^Ft, Gs^Ft, Gs^Ft, Gs^Ft, Gs, Gs, Gs, Gs, Gs, Gs^Ft, Gs, Wwf, Wwf, Ww, Ww, Ww, Wo, Ww, Ww, Gs, Hh, Gs^Ft
Hh, Hh, Hh, Hh, Mm, Hh, Hh, Hh, Rd, Rd, Hh, Hh, Mm, Hh, Gs^Ft, Rd, Rd, Hh, Rd, Rd, Hh, Rd, Gs^Ft, Gs^Ft, Gs^Ft, Gs^Ft, Gs^Ft, Gs^Ft, Gs, Gs, Gs, Gs, Ww, Ww, Ww, Wwf, Ww, Ww, Wo, Wwr, Ww, Wo, Ww, Ww, Gs, Hh, Mm
Hh, Hh, Hh, Hh, Hh, Hh, Gs, Rd, Hh, Hh, Mm, Mm, Hh, Hh, Hh, Hh, Hh, Rd, Hh, Hh, Rd, Rd, Gs^Ft, Gs^Ft, Gs^Ft, Gs^Ft, Gs^Ft, Gs, Gs, Gs, Gs, Ww, Ww, Ww, Ww, Ww, Wo, Wo, Ww, Ww, Wwf, Ww, Wwf, Wwf, Gs, Hh, Mm
Hh, Hh, Hh, Hh, Hh, Gs, Gs, Gs, Hh, Hh, Hh, Hh, Gs, Hh, Gs, Hh, Gs, Hh, Hh, Hh, Gs, Hh, Gs^Ft, Gs^Ft, Gs^Ft, Gs^Ft, Gs^Vht, Gs, Gs, Gs, Ww, Wwf, Wwf, Ww, Wo, Wo, Ww, Ww, Wwf, Wwf, Gs, Wwf, Gs, Gs, Gs^Ft, Hh, Hh
Hh, Hh, Gs, Gs, Gs, Gs, Gs, Gs, Hh, Hh, Gs, Gs, Gs, Gs, Gs, Gs, Gs, Gs, Gs, Gs, Gs, Gs, Gs, Gs, Gs, Gs, Gs, Gs, Gs, Gs, Ww, Wwf, Ww, Ww, Ww, Ww, Wwf, Wwf, Gs, Gs, Chr, Gs, Gs^Ft, Gs^Ft, Hh, Hh, Hh
Hh, Hh, Gs, Gs, Gs, Gs, Gs, Gs, Gs, Gs, Gs, Gs, Ww, Ww, Ww, Gs, Gs, Gs, Gs, Gs, Gs, Gs, Gs, Gs, Gs, Gs, Mm, Mm, Gs, Gs, Ww, Ww, Wo, Wwr, Ww, Wwf, Gs, Gs, Chr, Chr, Gs^Ft, Gs^Ft, Hh, Hh, Mm, Hh, Mm
Gs, Gs, Gs, Gs, Gs, Gs, Gs, Gs, Gs, Gs, Ww, Ww, Wo, Wo, Wo, Ww, Ww, Gs, Gs, Gs, Gs, Gs, Dd, Dd^Esd, Gs, Mm, Mm, Mm, Gs, Gs, Ww, Ww, Wo, Wo, Ww, Wwf, Gs, Chr, Chr, 6 Khr, Hh, Hh, Hh, Mm, Mm, Mm, Mm
Gs, Gs, Gs, Gs, Gs, Gs, Gs, Gs^Vht, Gs, Gs, Ww, Wo, Mm, Mm, Mm, Wo, Ww, Gs, Gs, Gs, Dd^Esd, Dd, Hd, Dd, Dd^Esd, Gs, Gs, Gs, Gs, Ww, Ww, Ww, Wo, Ww, Ww, Wwf, Gs, Gs, Gs^Ft, Gs^Ft, Hh, Hh, Mm, Mm, Mm, Mm, Mm
Gs, Gs, Gs, Chr, Chr, Gs, Gs, Gs, Gs, Gs, Ww, Wo, Mm, Mm^Xm, Mm, Wo, Ww, Gs, Gs, Gs, Dd, Dd, Hd, Dd, Dd^Esd, Gs, Gs, Gs, Ww, Ww, Wo, Ww, Wo, Ww, Ww, Gs, Gs, Gs^Ft, Gs^Ft, Gs^Ft, Hh, Mm, Mm, Mm, Mm, Mm, Hh
Gs, Gs, Rp, Gs, Gs, Gs, Gs, Gs, Gs, Gs, Ww, Wo, Wo, Mm, Wo, Wo, Ww, Gs, Gs, Gs, Dd, Md, Hd, Dd, Dd^Esd, Gs, Ww, Ww, Ww, Ww, Wwr, Wo, Ww, Ww, Ww, Gs, Gs, Gs^Ft, Hh^Vhh, Hh, Mm, Mm, Mm, Mm, Hh, Hh, Hh
Rp, Rp, Ww, Rp, Rp, Rp, Chr, Gs, Gs, Gs, Gs, Ww, Ww, Wo, Ww, Ww, Gs, Gs, Gs, Gs, Dd, Hd, Dd, Dd, Gs, Gs, Ww, Ww, Wo, Wo, Wwr, Wo, Ww, Ww, Gs, Gs, Gs, Gs, Hh, Hh, Mm, Mm, Hh, Hh, Dd^Do, Hh, Dd
Gs, Rp, Rp, Gs, Gs, Chr, Gs, Gs, Gs, Gs, Gs, Gs, Gs, Ww, Gs, Gs, Gs, Gs, Gs, Dd^Esd, Dd^Esd, Dd, Gs, Gs, Ww, Ww, Ww, Wo, Wwr, Wwr, Wo, Wo, Ww, Ww, Dd, Dd, Rd, Dd, Hd, Hh, Hh, Hh, Hd, Dd, Dd, Dd, Dd
Dd, Chr, Chr, Gs, Gs, Chr, Gs, Gs, Gs, Gs, Gs, Gs, Gs, Gs, Gs, Gs, Gs, Gs, Gs, Gs, Gs, Gs, Wwf, Wwf, Wwf, Ww, Ww, Wo, Ww, Wo, Ww, Ww, Dd, Dd, Dd, Hd, Rd, Dd, Hd, Hd, Md, Md, Hd, Dd, Re^Uf, Dd, Dd
Dd, Dd, Dd, Gs, Gs, Gs, Gs, Gs, Dd, Gs, Dd, Gs, Gs, Gs, Gs, Gs, Gs, Gs^Vht, Gs, Gs, Gs, Gs, Ww, Wwf, Wwf, Wwf, Wwf, Ww, Ww, Ww, Dd, Dd, Dd, Dd, Dd, Dd, Rd, Dd, Hd, Md, Md, Md, Hd, Dd, Dd^Esd, Dd, Dd
Dd, Dd, Dd, Gs, Dd, Gs, Dd, Dd, Dd, Rd, Dd, Dd, Dd, Dd, Dd, Dd, Dd, Gs, Dd, Gs, Dd, Gs, Ww, Ww, Ww, Wwf, Wwf, Dd^Dr, Dd, Dd, Dd, Hd, Md, Dd, Hd, Rd, Dd^Do, Hd, Md, Md, Md, Md, Hd, Dd^Esd, Dd, Dd, Rp
Dd, Dd, Dd, Dd, Dd, Dd, Dd, Dd, Dd, Rd, Dd, Dd, Dd^Esd, Dd, Dd, Dd, Dd, Rd, Dd, Dd, Dd, Dd, Ww, Wo, Wo, Ww, Ww, Dd, Dd, Dd, Dd^Esd, Dd^Esd, Hd, Hd, Dd, Rd, Md, Md, Hd, Md, Hd, Hd, Dd, Dd, Rp, Rp, Dd
Dd, Dd^Esd, Dd, Dd, Hd, Dd, Dd, Dd^Esd, Dd, Rd, Dd, Dd, Dd, Dd, Dd, Dd, Dd, Dd, Dd^Esd, Dd, Dd, Dd, Dd, Ww, Ww, Ww, Wwf, Wwf, Ww, Dd, Dd, Hd, Dd, Dd, Dd, Rd, Hd, Md, Hd, Hd, Dd, Dd^Esd, Rp, Rp, Dd, Dd, Dd
Dd, Dd, Dd, Hd, Re^Uf, Hd, Dd, Dd, Dd, Rd, Dd, Dd, Hd, Dd, Hd, Dd, Dd, Dd, Dd, Dd, Hd, Hd, Hd, Dd, Dd, Wwf, Ww, Ww, Ww, Dd, Dd, Dd, Dd^Esd, Dd, Rd, Rd, Dd, Hd, Dd, Dd, Dd, Rp, Dd, Dd^Esd, Dd^Esd, Dd, Dd
Dd^Esd, Dd, Dd, Dd, Dd, Dd, Dd^Do, Dd, Dd, Rd, Hd, Hd, Re^Uf, Hd, Dd, Dd, Dd, Rd, Dd, Dd^Do, Hd, Md, Hd, Hd, Dd, Ww, Ww, Wo, Ww, Ww, Wwf, Dd, Rd, Rd, Ch, Ch, Ch, Dd, Dd, Dd, Dd, Rp, Dd, Dd, Dd, Dd^Esd, Dd
Dd^Esd, Dd^Esd, Dd, Dd, Dd, Dd, Dd, Dd, Rd, Rd, Dd, Dd, Dd, Dd, Dd, Dd, Dd, Dd, Dd, Dd, Dd, Hd, Dd, Dd, Ww, Ww, Ww, Wo, Ww, Ww, Ww^Bw/, Rd, Ch, Ch, Rd, Rp^Vhc, Rp^Vhc, Ch, Ch, Dd, Gs, Rp, Dd, Dd^Esd, Dd, Dd, Dd
Dd, Dd^Esd, Dd, Dd, Dd, Dd, Dd, Rd, Hd, Dd, Dd, Dd, Dd, Dd^Vdt, Dd, Dd, Dd, Dd, Dd, Dd, Dd, Dd, Ww, Ww, Ww, Ww, Wo, Wo, Ww, Ww^Bw|, Ch, Ch, Rd, Rp^Vhc, Rp^Vhc, Rd, Rd, Rp^Vhc, Rp^Vhc, Ch, Rp, Rp, Dd, Dd, Dd, Dd^Esd, Dd
Dd, Dd, Dd, Dd, Hd, Dd, Dd, Rd, Dd, Dd, Dd, Dd, Dd, Dd, Hd, Dd, Hd, Hd, Dd, Rd, Dd, Dd, Ww, Wwr, Ww, Wwr, Ww, Ww, Ch, Rr, Rr, Rp^Vhc, Rp^Vhc, Rd, Rd, Rp^Vhc, Rr, Rr, Rr, Rr, Rr, Rp, Ch, Dd^Vdt, Dd^Esd, Dd, Dd
Dd, Dd, Dd^Vdt, Dd, Dd, Dd, Dd, Rd, Rd, Dd, Dd, Dd, Hd, Hd, Dd, Hd, Dd, Dd, Dd, Dd, Dd, Dd, Ww, Ww, Wo, Ww, Ch, Ch, Rr, Rr, Dd^Dr, Rr, Rr, Rp^Vhc, Rr, Rr, Ch, Ch, Ch, Ds, Rr, Rr, Rr, Ch, Ch, Dd, Dd
Dd, Dd, Dd, Dd, Dd, Dd, Dd, Dd^Dr, Rd, Hd, Dd, Dd, Dd, Dd, Dd^Esd, Dd, Dd^Esd, Dd^Esd, Dd^Esd, Dd, Dd, Dd, Ww, Ww, Wo, Ww, Ch, Rr, Rp^Vhc, Rd, Dd^Vda, Dd^Vda, Dd^Do, Rr, Gg^Fet, Rr, Ch, Kh, 5 Kh, Ch, Rr, Dd^Vda, Dd^Vda, Rr, Ch, Dd, Dd
Dd, Dd, Dd, Dd, Hd, Hd, Dd, Dd, Dd, Rd, Dd^Esd, Dd^Esd, Dd^Esd, Dd^Esd, Dd, Dd^Esd, Dd, Dd^Esd, Dd, Dd, Ch, Dd, Ww, Ww, Wo^Bw/, Ww^Bw/, Ch, Rr, Rp^Vhc, Rd, Rd, Dd^Vda, Ch, Rr, Rr, Rr, Ds, Ch, Ch, Ch, Rr, Dd^Do, Dd^Vda, Rr, Rp, Gs, Rp
Dd, Dd, Dd, Dd, Hd, Hd, Dd, Dd, Dd^Vdt, Dd, Dd, Dd, Dd, Dd, Dd, Dd, Dd, Dd, Rr, Ch, Dd^Vda, Ch, Ww^Bw/, Wo^Bw/, Wo, Ww, Ds, Rr, Rr, Rp^Vhc, Ds, Rd, Ww, Ds, Rr, Rr, Rr, Rr, Rr, Rr, Gg^Fet, Rr, Rr, Rr, Rp, Rp, Gs
Dd, Dd, Dd, Dd, Re^Uf, Dd, Dd, Dd, Dd, Dd^Do, Rd, Dd, Dd, Dd, Dd, Dd, Ch, Rr, Rd, Rr, Rr, Ch, Ww, Wo, Wo, Ww, Ch, Rp^Vhc, Ch, Rr, Ww, Ww^Bw|, Ww, Ww^Bw/, Ww^Bw|, Ds, Ch, Dd^Vda, Dd^Vda, Rr, Rr, Rr, Dd^Vda, Rr, Ch, Gs, Gs
Dd, Dd, Hd, Dd, Dd, Dd, Hd, Dd, Dd, Dd, Rd, Dd, Rd, Dd, Dd, Ch, Dd^Vda, Rr, Rd, Dd^Vda, Ch, Ww, Ww, Wo, Wo, Ww, Ww, Ch, Ww, Ww^Bw|, Ww, Ww, Ww, Ww, Ww, Ww, Gs^Ft, Ds, Dd^Vda, Rr, Ds, Rr, Dd^Do, Dd^Vda, Ch, Gs, Gs
Dd, Dd, Dd, Hd, Dd, Hd, Dd, Hd, Hd, Dd, Dd, Rd, Hd, Rd, Rd, Ch, Rr, Rr, Rd, Rr, Ww, Ww, Ww, Wo, Wo, Ww, Ww, Ww, Ww, Ww, Wo, Ww, Ww, Ww, Ww, Ww, Ss^Vhs, Ss, Dd^Vda, Rr, Ds, Rr, Ch, Ch, Gs, Gs, Gs
Dd, Dd^Esd, Dd, Dd, Dd^Esd, Dd, Dd, Dd, Dd, Dd, Dd, Dd, Dd, Dd, Rp, Rr, Rr, Rd, Rr, Ww^Bw\, Ww, Ww, Wo, Wo, Wo, Wo, Wo, Ww, Wo, Wo, Wo, Wo, Ww, Ww, Ww^Bw\, Ww^Bw\, Rr, Ss, Rr, Rr, Rp, Rp, Gs, Gs, Gs, Gs, Gs
Dd, Dd^Esd, Dd^Esd, Dd, Dd^Esd, Dd, Dd, Dd, Dd, Dd, Dd, Dd, Rp, Rp, Dd, Ch, Dd^Vda, Rd, Rr, Ww^Bw\, Ww, Ww, Wo, Wo, Wo, Wo, Wo, Wo, Wo, Wo, Ww, Ww, Ww, Ww, Ch, Rr, Dd^Vda, Rr, Ch, Ch, Gs, Rp, Rp, Gs, Gs, Gs, Gs
Dd, Dd, Dd, Dd, Dd, Dd, Dd, Dd, Dd, Dd, Rp, Rp, Dd, Dd, Dd, Ch, Ch, Rd, Ch, Ww, Ww, Wo, Wo, Wo, Wo, Wo, Wo, Wo, Wo, Wo, Ww, Ww, Ww, Ww, Gs, Ch, Ch, Ch, Gs, Gs, Gs, Gs, Rp, Gs, Gs, Gs, Gs
