Wo, Ww, Ww, Dd, Dd, Dd, Dd, Dd, Dd, Dd, Dd, Dd, Dd, Dd, Hd, Dd, Dd, Dd, Dd, Dd, Dd, Dd, Dd, Dd, Dd, Dd, Dd, Dd, Dd, Dd, Wo, Ww, Ww, Md, Md, Md, Md
Ww, Wo, Wo, Ww, Ww, Ww, Ww, Dd, Dd, Dd, Dd, Dd, Dd, Dd, Hd, Dd, Dd, Dd, Dd, Hd, Dd, Dd, Hd, Dd, Dd, Hd, Md, Dd, Dd, Dd, Ww, Wo, Wo, Ww, Ww, Ww, Ww
Dd, Ww, Ww, Wo, Wo, Wo, Wo, Ww, Ww, Dd, Ww, Dd, Dd, Dd, Dd, Hd, Dd, Dd, Md, Md, Md, Dd, Hd, Dd, Dd, Hd, Hd, Md, Dd, Dd, Dd, Ww, Ww, Wo, Wo, Wo, Wo
Dd, Dd, Dd, Ww, Ww, Ww, Ww, Wo, Wo, Ww, Wo, Ww, Ww, Dd, Dd, Hd, Hd, Dd, Hd, Hd, Dd, Dd, Hd, Md, Dd, Dd, Dd, Hd, Dd, Dd, Dd, Dd, Gs, Ww, Ww, Ww, Ww
Dd, Dd, Dd, Dd, Dd, Dd, Dd, Ww, Ww, Wo, Wo, Wo, Wo, Ww, Ww, Dd, Dd, Dd, Dd, Dd, Dd, Dd, Dd, Hd, Dd, Dd, Dd, Dd, Dd^Vdt, Dd, Dd, Dd, Gs, Gs, Gs, Gs, Gs
Dd, Hd, Dd, Dd, Hd, Dd, Dd, Dd, Ww, Wo, Wo, Wo, Wo, Wo, Wo, Ww, Gs, Dd, Gs, Dd^Vdt, Gs, Dd, Gs, Dd, Gs, Gs, Gs, Gs, Gs, Gs, Dd, Gs, Dd, Hh, Gs, Gs, Gs
Hd, Hd, Dd, Ce, Ce, 4 Ke, Dd, Dd, Dd, Ww, Wwr, Ww, Ww, Wo, Wo, Ww, Ww, Gs, Dd, Gs, Gs, Gs, Gs, Dd, Dd, Dd, Dd, Dd, Gs, Gs, Gs, Dd, Gs, Dd, Dd, Gs, Gs
Dd, Dd, Dd, Hd, Ce, Ce, Ce, Ce, Dd, Dd, Gs, Gs, Gs, Ww, Ww, Ww, Wwf, Gs, Gs, Gs, Dd, Gs, Dd, Gs, Gs, Gs, Gs, Gs, Gs, Gs, Ce, Gs, Gs, Dd, Dd, Gs, Gs
Dd, Dd, Dd, Ce, Dd, Dd, Dd, Dd, Dd, Dd^Vdt, Gs, Gs, Wwf, Wwf, Wwf, Wwf, Wwf, Gs, Gs, Gs, Dd, Gs, Dd, Gs, Hh, Dd, Dd, Dd, Gs, Ce, 5 Ke, Ce, Gs, Hh, Dd, Gs, Gs
Dd, Dd, Dd, Dd, Dd, Dd, Gs, Dd, Gs, Gs, Dd, Gs, Gs, Wwf, Wwf, Wwf, Wwf, Gs, Gs, Dd, Dd, Gs, Gs, Gs, Hh, Gs, Gs, Gs, Gs, Ce, Ce, Ce, Gs, Gs, Dd, Gs, Gs
Gs, Dd, Gs, Gs, Gs, Gs, Hh, Gs, Gs, Gs, Hh, Dd, Gs, Wwf, Ww, Wwf, Wwf, Gs, Gs, Hh, Gs, Gs, Dd^Vdt, Dd, Dd, Dd, Gs, Gs, Gs, Gs, Gs, Gs, Gs, Gs, Dd, Gs, Gs
Gs, Gs, Dd, Dd, Gs, Gs, Dd, Gs, Gs, Gs, Dd, Gs, Ww, Ww, Wo, Ww, Ww, Gs, Dd, Gs, Gs, Gs, Gs, Gs, Gs, Dd, Dd, Dd, Dd, Hh, Mm^Xm, Hh, Gs, Gs, Gs, Gs, Gs
Dd, Hh, Gs, Gs, Gs, Gs, Dd^Vdt, Gs, Gs, Dd, Hh, Gs, Ww, Wo, Wo, Wo, Ww, Gs, Dd, Dd, Gs, Gs, Dd, Hh, Gs, Gs, Gs, Gs, Dd, Mm, Mm^Xm, Mm, Hh, Dd^Vdt, Dd, Dd, Gs
Dd, Gs, Gs, Gs, Dd, Gs, Gs, Gs, Gs, Dd, Gs, Gs, Ww, Wo, Wo, Ww, Mm, Hh, Gs, Gs, Gs, Dd, Gs, Hh, Gs, Dd^Dr, Dd, Gs, Gs, Hh, Dd, Mm^Xm, Mm^Xm, Gs, Gs, Gs, Gs
Hh, Dd, Gs, Gs, Dd, Hh, Dd, Gs, Gs, Dd, Gs, Gs, Ww, Wo, Wo, Ww, Mm, Hh, Gs, Dd, Dd, Gs, Gs, Dd, Dd, Gs, Hh, Dd, Dd, Gs, Gs, Hh, Dd, Gs, Gs, Gs, Gs
Hh, Hh, Gs, Gs, Gs, Dd, Hh, Gs, Hh, Gs, Gs, Gs, Ww, Wo, Wo, Ww, Ww, Hh, Gs, Gs, Hh, Dd, Gs, Dd, Hh, Gs, Gs, Gs, Gs, Gs, Gs, Gs, Dd, Gs, Gs, Gs, Gs
Gs, Gs, Gs, Dd, Hh, Gs, Gs, Gs, Dd, Mm, Gs, Gs, Ww, Wo, Ww^Vm, Wo, Ww, Gs, Gs, Gs, Dd, Gs, Gs, Gs, Gs, Gs, Dd, Gs, Dd, Gs, Dd, Dd, Dd, Gs, Gs, Gs, Gs
Gs, Gs, Gs, Dd, Gs, Hh, Gs, Gs, Gs, Gs, Hh, Gs, Ww, Ww, Wo, Wo, Wo, Ww, Gs, Gs, Gs, Dd, Dd, Gs, Hh, Dd, Dd, Gs, Dd, Gs, Gs, Gs, Dd, Dd, Hh, Gs, Gs
Gs, Dd^Vdt, Gs, Hh, Gs, Dd, Dd, Gs, Gs, Gs, Dd, Gs, Gs, Ww, Ww, Wo, Wo, Ww, Ww, Gs, Gs, Hh, Gs, Dd, Dd, Mm, Gs, Gs, Gs, Dd, Dd, Hh, Hh, Dd, Gs, Gs, Gs
Gs, Dd, Gs, Gs, Gs, Mm, Dd, Hh, Hh, Dd, Gs, Dd, Dd, Gs, Ww, Wo, Wo, Wo, Wo, Ww, Ww, Gs, Gs, Gs, Dd, Hh, Gs, Dd, Dd^Vdt, Gs, Gs, Gs, Gs, Gs, Gs, Gs, Gs
Dd, Dd, Gs, Dd, Gs, Hh, Dd, Dd, Gs, Gs, Gs, Dd^Vdt, Gs, Gs, Gs, Ww, Ww, Wo, Wo, Ww, Ww, Gs, Gs, Gs, Gs, Dd, Dd, Gs, Gs, Gs, Dd, Gs, Dd, Gs, Gs, Gs, Hh
Gs, Dd, Hh, Dd, Gs, Gs, Gs, Gs, Gs, Gs, Dd, Gs, Gs, Gs, Dd, Hh, Gs, Ww, Ww, Ww, Wo, Ww, Ww, Gs, Gs, Dd, Hh, Dd, Gs, Gs, Gs, Dd, Gs, Gs, Gs, Hh, Hh
Gs, Gs, Hh, Dd, Gs, Gs, Gs, Dd, Hh, Dd, Gs, Dd, Gs, Gs, Gs, Dd^Vdt, Dd, Gs, Gs, Ww, Wo, Wo, Ww, Gs, Gs, Dd, Hh, Dd, Gs, Gs, Gs, Gs^Ft, Gs, Gs, Gs, Gs, Gs
Gs, Gs, Gs, Hh, Dd, Dd, Gs, Hh, Hh, Gs, Gs, Gs, Dd, Dd, Gs, Gs, Gs, Gs, Ww, Ww, Wo, Wo, Ww, Ww, Gs, Gs, Dd, Dd, Dd, Gs, Gs, Gs, Dd, Dd, Hh, Gs, Gs
Gs, Gs, Gs, Dd, Dd, Gs, Gs, Dd, Dd, Gs, Gs, Dd, Gs, Hh, Gs, Gs, Gs, Ww, Wo, Wo, Wo, Wo, Wo, Ww, Ww, Gs, Gs, Dd, Gs, Gs, Dd, Dd, Hh, Dd, Dd, Gs, Gs
Rr, Gs, Ce, Ce, Gs, Dd^Vdt, Gs, Gs, Dd, Dd, Dd, Gs, Gs, Gs, Gs, Gs, Ww, Ww, Wo, Wo, Kh, Wo, Wo, Wwr, Ww, Gs, Gs, Gs, Hh, Hh, Gs, Gs, Gs, Dd, Dd^Vdt, Gs, Gs
Gs, Rr, 1 Ke, Ce, Ce, Gs, Dd, Dd, Gs, Gs, Gs, Dd^Vdt, Gs, Gs, Gs, Ww, Wo, Wo, Wo, Wo, Ch, Wo, Wo, Wo, Ww, Gs, Gs, Hh, Mm, Hh, Gs, Gs^Ft, Gs^Ft, Gs^Ft, Gs^Ft, Gs, Gs
Gs, Rr, Rr, Ce, Ce, Gs, Gs, Dd, Hh, Dd, Dd, Gs, Gs, Gs, Ww, Ww, Wo, Wo, Ch, Ch, Gs^Vht, Ch, Wo, Wo, Ww, Gs^Ft, Hh, Mm, Mm^Xm, Mm^Xm, Gs, Gs^Ft, Rr, Gs, Gs, Gs, Gs
Gs, Gs, Gs, Rr, Rr, Gs, Gs, Dd, Gs, Dd, Gs, Dd, Gs, Gs, Ww, Wo, Ww, Ww, Ch, Gs^Vht, Rr, Ch, Ww, Wo, Ww, Gs, Hh, Mm, Hh, Mm^Vhh, Rr, Rr, Gs^Ft, Rr, Rr, Gs, Gs
Gs, Gs, Gs, Gs, Gs, Rr, Rr, Gs, Gs, Gs, Gs, Gs, Gs, Gs, Ww, Wo, Ww, Ch, Gs^Vht, 2 Kh, Rr, Ch, Ww, Wo, Wo, Ww, Gs^Ft, Hh, Rr, Rr, Mm, Hh, Gs^Ft, Gs^Ft, Gs, Rr, Rr
Gs, Gs, Dd^Vdt, Gs, Dd, Gs, Gs, Rr, Rr, Dd^Vdt, Rr, Gs, Rr, Gs, Ww, Wo, Ww, Ch, Dd, Gs^Vht, Rr, Ch, Ch, Ww, Wo, Ww, Rr, Rr, Hh, Mm, Hh, Hh, Gs, Gs, Gs, Hh, Hh
Gs, Gs, Dd, Gs, Dd, Dd, Gs, Gs, Gs, Rr, Gs, Rr, Gs, Rr, Ww^Bw\, Wo, Ww, Ch, Ch, Kh, Rr, Dd, Ch, Ww, Wo^Bw/, Ww^Bw/, Ww, Gs^Ft, Gs, Hh, Gs, Gs, Gs^Vht, Gs, Gs, Hh, Hh
Gs, Gs, Gs, Dd, Dd, Hh, Dd, Dd, Gs, Dd, Gs, Gs, Ww, Ww, Wo, Wo^Bw\, Ww^Bw\, Ch, Rr, Rr, Ch, Ch, Rr, Ww^Bw/, Ww, Wo, Wo, Ww, Ww, Gs, Gs, Gs^Vht, 3 Ke, Ce, Gs, Gs, Hh
Gs, Gs, Dd, Hh, Mm, Mm, Mm, Hh, Dd, Dd, Gs, Gs, Ww, Wo, Ww, Ww, Ch, Rr, Rr, Ch, Rr, Rr, Dd^Vda, Ch, Wwr, Ww, Ww, Wo, Wo, Ww, Gs, Ce, Ce, Ce, Gs, Hh, Hh
Gs, Gs, Dd, Mm, Mm, Mm, Hh, Hh, Mm, Hh, Gs, Gs, Ww, Wo, Ww, Ch, Ch, Dd^Vda, Dd, Rr, Dd, Dd, Ch, Ch, Wwr, Hh, Mm, Ww, Wo, Ww, Ww, Gs, Gs, Gs, Gs, Gs, Gs
Gs, Dd, Hh, Mm, Mm, Mm^Vhh, Mm, Mm, Dd, Dd, Gs, Ww, Wo, Wo, Ww, Gs, Gs, Ch, Ch, Rr, Ch, Ch, Gs, Gs, Gs, Wwr, Wwr, Ww, Ww, Wo, Wo, Ww, Ww, Gs, Gs, Gs, Gs
Gs, Gs, Hh, Mm, Mm, Mm, Dd, Hh, Dd, Gs, Gs, Ww, Wo, Ww, Gs, Gs, Gs, Gs, Gs, Rr, Gs, Gs, Gs, Gs, Gs, Gs, Gs, Gs, Gs, Ww, Ww, Wo, Wo, Ww, Ww, Gs, Gs
Dd, Gs, Gs, Dd, Dd, Dd, Gs, Gs, Dd, Gs, Gs, Ww, Wo, Ww, Gs, Gs^Ft, Gs^Ft, Gs^Ft, Gs, Rr, Gs, Gs, Gs, Gs, Gs, Gs, Gs, Gs, Gs, Gs, Gs, Ww, Ww, Wo, Ww, Gs, Gs
Dd, Dd, Gs, Gs, Gs, Gs, Dd, Gs, Gs, Gs, Gs, Ww, Wo, Ww, Gs, Gs^Ft, Gs^Ft, Gs^Ft, Gs, Rr, Gs, Gs, Gs, Gs, Gs, Gs, Gs, Gs, Gs, Gs, Gs, Gs, Ww, Wo, Wo, Ww, Gs
Gs, Gs, Dd, Gs, Dd, Dd, Dd, Gs, Gs, Gs, Gs, Ww, Wo, Ww, Gs, Gs, Gs^Ft, Gs^Ft, Gs^Ft, Rr, Rr, Gs, Gs, Gs, Gs, Gs, Gs^Ft, Gs, Gs^Ft, Gs, Gs^Vht, Gs, Gs, Ww, Wo, Ww, Ww
Gs, Gs, Dd, Gs, Gs, Gs, Gs, Dd, Gs, Gs, Gs, Ww, Wo, Ww, Gs^Ft, Gs^Ft, Gs^Ft, Gs^Ft, Gs^Ft, Gs, Gs, Rr, Gs, Gs, Gs, Gs^Ft, Gs^Ft, Gs^Ft, Gs^Ft, Gs^Ft, Gs^Ft, Gs^Ft, Gs, Ww, Wo, Wo, Ww
