border_size=1
usage=map

Gs^Ft       , Gs^Ft       , Gs^Ft       , Mm          , Mm          , Mm          , Mm          , Mm          , Mm          , Mm          , Mm          , Hh          , Rr          , Gs          , Gs          , Gs          , Ds          , Gs          , Gs          , Gs          , Ds          , Gs          , Gs          , Gs          , Gs          , Gs          , Gs          , Gs          , Gs          , Ww          , Ww          , Ww          , Wo          , Wo          , Wo          , Wo          
Gs          , Gs^Ft       , Gs^Ft       , Gs^Ft       , Mm^Vhh      , Mm          , Mm          , Mm          , Mm          , Mm^Xm       , Mm          , Hh          , Rr          , Gs          , Ds          , Gs          , Gs          , Ds          , Gs          , Hh          , Hh          , Gs          , Ds          , Gs          , Gs          , Gs          , Ds          , Gs          , Gs          , Ww          , Ww          , Ww          , Ww          , Wo          , Wo          , Wo          
Gs          , Gs          , Gs          , Hh          , Mm          , Mm          , Mm          , Mm          , Mm          , Mm^Xm       , Mm^Vhh      , Hh          , Rr          , Gs          , Ds          , Gs          , Hh          , Ds          , Ds          , Ds          , Gs          , Gs          , Ds          , Gs          , Hh          , Ds          , Gs          , Gs          , Gs          , Ww          , Ww          , Ww          , Ww          , Wo          , Wo          , Wo          
Gs          , Gs          , Gs          , Hh          , Hh          , Mm          , Mm^Xm       , Mm          , Mm          , Mm          , Hh          , Hh          , Rr          , Gs          , Hh          , Ds          , Gs          , Dd^Vda      , Gs          , Gs          , Hh          , Ds          , Gs          , Hh          , Gs          , Ds          , Gs          , Gs          , Gs          , Ww          , Ww          , Ww          , Ww          , Wo          , Wo          , Wo          
Gs          , Gs          , Gs          , Gs^Ft       , Gs^Ft       , Mm          , Mm^Xm       , Mm          , Mm          , Mm          , Gs^Ft       , Gs^Ft       , Rr          , Gs          , Ds          , Gs          , Ds          , Ds          , Gs          , Gs          , Ds          , Ds          , Hh^Vhh      , Gs          , Gs          , Gs          , Ce          , Gs          , Ww          , Ww          , Ww          , Ww          , Wo          , Wo          , Wo          , Wo          
Gs          , Gs          , Gs          , Gs          , Gs^Ft       , Mm          , Mm          , Mm^Xm       , Mm          , Hh          , Gs          , Gs          , Rr          , Hh          , Ds          , Hh          , Ds          , Hh          , Gs          , Hh          , Hh          , Gs          , Ds          , Gs          , Gs          , Ce          , 1 Ke        , Ce          , Ww          , Ww          , Ww          , Wo          , Wo          , Wo          , Wo          , Wo          
Gs          , Gs          , Gs          , Gs          , Gs^Ft       , Mm          , Mm          , Mm^Xm       , Mm          , Hh          , Gs^Ft       , Gs          , Rr          , Ds          , Ds          , Hh          , Gs          , Gs          , Dd^Vdt      , Gs          , Gs          , Ds          , Ds          , Hh          , Gs          , Ce          , Ce          , Ce          , Ww          , Ww          , Wo          , Wo          , Wo          , Wo          , Wo          , Wo          
Gs          , Gs          , Gs          , Gs          , Gs^Ft       , Hh          , Mm^Vhh      , Mm^Xm       , Mm          , Gs^Ft       , Gs^Ft       , Gs          , Rr          , Gs          , Hh          , Gs          , Ds          , Ds          , Hh          , Ds          , Gs          , Gs          , Ds          , Gs          , Gs          , Gs          , Gs          , Ww          , Ww          , Ww          , Wo          , Wo          , Wo          , Wo          , Wo          , Wo          
Gs          , Gs          , Gs          , Gs          , Hh          , Hh          , Mm          , Mm          , Mm          , Hh          , Gs^Ft       , Gs          , Rr          , Gs          , Gs          , Gs          , Hh          , Gs          , Gs          , Gs          , Gs          , Hh          , Gs          , Gs^Vht      , Gs          , Gs          , Ds          , Ww          , Ww          , Ww          , Wo          , Wo          , Wo          , Wo          , Wo          , Wo          
Gs          , Gs          , Gs          , Gs^Ft       , Hh          , Mm          , Mm          , Mm          , Hh          , Hh          , Gs          , Gs          , Rr          , Gs          , Gs          , Gs          , Ce          , Gs          , Ss          , Gs          , Gs          , Gs          , Gs          , Gs          , Gs          , Ds          , Ww          , Ww          , Ww          , Ww          , Wo          , Wo          , Wo          , Wo          , Wo          , Wo          
Gs          , Gs          , Gs          , Gs          , Gs^Ft       , Hh          , Hh          , Hh          , Gs^Ft       , Gs^Ft       , Gs          , Gs          , Rr          , Gs^Vht      , Re^Gvs      , Re^Gvs      , Re^Gvs      , Re^Gvs      , Re^Gvs      , Ce          , Re^Gvs      , Gs^Vht      , Gs          , Gs          , Ww          , Ds          , Ww          , Ww          , Wo          , Wo          , Wo          , Wo          , Wo          , Wo          , Wo          , Wo          
Gs          , Gs          , Gs          , Gs          , Gs^Ft       , Gs^Ft       , Gs          , Ce          , Gs          , Gs          , Rr          , Rr          , Re^Gvs      , Ce          , Re^Gvs      , Re^Gvs      , Wwf         , Re^Gvs      , Wwf         , Re^Gvs      , Re^Gvs      , Re^Gvs      , Ww          , Ww          , Ww          , Ww          , Ww          , Wo          , Wo          , Wo          , Wo          , Wo          , Wo          , Wo          , Wo          , Wo          
Gs          , Gs          , Gs          , Gs          , Gs          , Gs          , Gs          , Gs          , Rr          , Rr          , Re^Gvs      , Re^Gvs      , Re^Gvs      , Re^Gvs      , Ww          , Wwf         , Wwf         , Wwf         , Wwf         , Ww          , Ww          , Ww          , Ww          , Ww          , Hh          , Ww          , Ww          , Wo          , Wo          , Wo          , Wo          , Wo          , Wo          , Wo          , Wo          , Wo          
Gs          , Gs          , Gs          , Gs          , Gs          , Gs          , Gs^Ft       , Hh          , Rr          , Gs^Ft       , Ww          , Re^Gvs      , Ww          , Ww          , Ww          , Wwf         , Wwf         , Wwf         , Wwf         , Ww          , Ww          , Ww          , Hh          , Hh          , Mm          , Ww          , Ww          , Wo          , Wo          , Wo          , Wo          , Wo          , Wo          , Wo          , Wo          , Wo          
Gs          , Gs          , Gs          , Gs^Ft       , Hh          , Gs^Ft       , Hh          , Gs^Ft       , Ww^Bw|      , Ww          , Ww          , Ww          , Ww          , Ww          , Re^Gvs      , Wwf         , Re^Gvs      , Wwf         , Ss          , Re^Gvs      , Re^Gvs      , Re^Gvs      , Ds          , Ds          , Ww          , Ww          , Ww          , Wo          , Wo          , Wo          , Wo          , Wo          , Wo          , Wo          , Wo          , Wo          
Gs          , Gs          , Gs          , Gs^Ft       , Gs          , Hh          , Ww          , Ww          , Ww^Bw|      , Ww          , Gs^Ft       , Ww          , Re^Gvs      , Re^Gvs      , Re^Gvs      , Chs         , Re^Gvs      , Re^Gvs      , Re^Gvs      , Re^Gvs      , Ss^Vhs      , Re^Gvs      , Ds          , Ds          , Ww          , Ww          , Ww          , Wo          , Wo          , Wo          , Wo          , Wo          , Wo          , Wo          , Wo          , Wo          
Ww          , Gs          , Ww          , Gs          , Ww          , Ww          , Ww          , Ww          , Rr          , Gs^Ft       , Gs^Ft       , Re^Gvs      , Re^Gvs      , Ss          , Ss          , Re^Gvs      , Ss          , Re^Gvs      , Ss          , Ss          , Re^Gvs      , Re^Gvs      , Ds          , Ds          , Ww          , Ww          , Ww          , Wo          , Wo          , Wo          , Wo          , Wo          , Wo          , Wo          , Ww          , Wo          
Ww          , Ww          , Ww          , Ww          , Ww          , Ww          , Gs          , Gs          , Rr          , Gs          , Gs^Ft       , Re^Gvs      , Re^Gvs      , Re^Gvs      , Re^Gvs      , Ss          , Re^Gvs      , Re^Gvs      , Re^Gvs      , Re^Gvs      , Re^Gvs      , Ds          , Ds          , Ds          , Ds          , Ww          , Ww          , Ww          , Ww          , Wo          , Wo          , Wo          , Ww          , Ww          , Wwf         , Ww          
Ww          , Ww          , Ww          , Ww          , Gs          , Gs          , Gs^Ft       , Gs          , Rr          , Gs          , Gs          , Gs^Vht      , Re^Gvs      , Re^Gvs      , Ss          , Re^Gvs      , Re^Gvs      , Ss          , Re^Gvs      , Ss          , Re^Gvs      , Ds          , Ds          , Ds          , Ds          , Mm          , Ww          , Ww          , Ww          , Wo          , Wo          , Wo          , Ww          , Wwf         , Hh          , Ds          
Gs          , Gs          , Hh          , Gs          , Gs^Ft       , Gs^Ft       , Hh          , Ce          , Rr          , Gs          , Gs^Ft       , Gs          , Gs          , Re^Gvs      , Re^Gvs      , Re^Gvs      , Ss          , Ss          , Re^Gvs      , Re^Gvs      , Re^Gvs      , Ds          , Ds          , Ds          , Hh          , Hh          , Ww          , Ww          , Wo          , Wo          , Wo          , Wo          , Chw         , Ds          , Mm          , Mm          
Gs^Ft       , Gs^Ft       , Gs^Ft       , Gs^Ft       , Gs^Ft       , Gs^Ft       , Gs          , Gs          , Rr          , Gs^Ft       , Hh          , Gs^Ft       , Gs^Ft       , Gs          , Gs          , Re^Gvs      , Re^Gvs      , Re^Gvs      , Ss          , Ss          , Re^Gvs      , Ss          , Re^Gvs      , Hh          , Ww          , Ww          , Ww          , Ww          , Wo          , Wo          , Wo          , Ww^Vm       , Wwf         , Ds          , Mm          , Mm^Xm       
Gs^Ft       , Gs^Ft       , Gs^Ft       , Gs^Ft       , Hh          , Gs^Ft       , Gs          , Gs          , Rr          , Gs^Ft       , Rr          , Gs^Vht      , Gs          , Gs          , Gs          , Gs^Vht      , Gs          , Re^Gvs      , Re^Gvs      , Re^Gvs      , Ww          , Re^Gvs      , Ww          , Ww          , Ds          , Ww          , Ww          , Ww          , Wo          , Wo          , Wo          , Chw         , Ww^Vm       , Ww^Vm       , Mm          , Mm^Xm       
Gs^Ft       , Gs          , Gs^Ft       , Gs^Ft       , Gs^Ft       , Gs^Ft       , Ww          , Gs          , Rr          , Rr          , Ce          , Rr          , Rr          , Ce          , Ce          , Gs          , Gs^Vht      , Re^Gvs      , Ww          , Ww          , Re^Gvs      , Ww          , Re^Gvs      , Re^Gvs      , Ds          , Ds          , Ww          , Ww          , Ww          , Wo          , Ww          , Ww          , Chw         , Ds          , Wwf         , Mm          
Gs          , Gs^Ft       , Ww          , Gs^Ft       , Ww          , Ww          , Gs^Ft       , Ww          , Ww^Bw|      , Ce          , Gs^Vht      , Gg^Ve       , Rr          , Rr          , Ce          , Gs          , Ww          , Ww          , Re^Gvs      , Re^Gvs      , Re^Gvs      , Re^Gvs      , Re^Gvs      , Re^Gvs      , Gs          , Ds          , Ww          , Ww          , Ww          , Ww          , Ww          , Ww          , Wo          , Ww          , Ww          , Ds          
Ww          , Ww          , Gs^Ft       , Ww          , Gs^Ft       , Gs^Ft       , Hh          , Gs          , Rr          , Ww          , Ww          , Rr          , Rr          , Gs^Vht      , Ww          , Ww          , Gs^Vht      , Re^Gvs      , Re^Gvs      , Re^Gvs      , Ss          , Re^Gvs      , Gs^Ft       , Gs^Ft       , Gs          , Ds          , Ww          , Ww          , Ww          , Ww          , Wo          , Wo          , Wo          , Wo          , Wo          , Wo          
Gs          , Gs^Ft       , Gs^Ft       , Gs^Ft       , Hh          , Hh          , Hh          , Gs          , Rr          , Gs^Ft       , Gs^Ft       , Ww          , Ww          , Ww          , Gs^Ft       , Gs          , Gs          , Re^Gvs      , Gs          , Ss          , Gs^Ft       , Hh          , Gs^Ft       , Gs^Ft       , Gs          , Gs          , Ww          , Ww          , Ww          , Wo          , Wo          , Wo          , Wo          , Wo          , Wo          , Wo          
Gs          , Gs          , Gs          , Gs^Ft       , Hh          , Mm          , Hh          , Gs^Ft       , Rr          , Gs          , Gs^Ft       , Gs^Ft       , Hh          , Gs^Ft       , Gs^Ft       , Gs          , Gs          , Gs^Ft       , Gs          , Hh          , Gs^Ft       , Hh          , Gs          , Gs          , Gs          , Gs          , Gs          , Ww          , Ww          , Ww          , Wo          , Wo          , Wo          , Wo          , Wo          , Wo          
Gs          , Gs          , Gs          , Hh          , Hh          , Mm          , Mm          , Hh          , Rr          , Gs          , Gs          , Hh          , Gs^Ft       , Hh          , Gs          , Gs          , Gs          , Gs^Ft       , Hh          , Gs          , Gs          , Gs          , Gs          , Gs          , Gs          , Gs          , Gs          , Ww          , Ww          , Ww          , Ww          , Wo          , Wo          , Wo          , Wo          , Wo          
Gs          , Gs          , Gs^Vht      , Gs^Ft       , Hh          , Mm          , Hh          , Hh          , Rr          , Gs          , Gs^Vht      , Gs          , Gs          , Ce          , Gs          , Gs          , Gs          , Gs^Ft       , Gs^Ft       , Gs          , Gs          , Gs^Vht      , Gs          , Gs          , Gs          , Gs          , Gs          , Gs          , Ww          , Ww          , Ww          , Wo          , Wo          , Wo          , Wo          , Wo          
Gs          , Gs          , Gs^Ft       , Gs^Ft       , Hh          , Mm          , Hh          , Gs^Ft       , Rr          , Gs          , Gs          , Gs          , Gs          , Gs          , Gs          , Gs          , Gs^Vht      , Hh          , Hh          , Gs^Ft       , Gs          , Gs          , Gs          , Gs          , Gs          , Gs          , Gs          , Gs          , Gs          , Ww          , Ww          , Ww          , Wo          , Wo          , Wo          , Wo          
Gs          , Gs          , Hh          , Hh          , Mm          , Mm          , Hh          , Gs^Ft       , Gs          , Rr          , Gs          , Gs          , Gs          , Gs          , Gs^Ft       , Gs          , Gs          , Hh          , Gs^Ft       , Hh          , Gs          , Gs          , Gs          , Gs          , Ce          , Gs          , Gs          , Gs          , Gs          , Ww          , Ww          , Ww          , Wo          , Wo          , Wo          , Wo          
Hh          , Hh          , Mm          , Mm          , Hh          , Mm          , Hh          , Gs          , Gs          , Rr          , Rr          , Gs          , Gs          , Gs          , Hh          , Gs^Ft       , Gs^Ft       , Gs          , Gs          , Gs          , Gs          , Gs          , Ce          , Ce          , Ke          , Ce          , Gs          , Gs          , Gs          , Ww          , Ww          , Ww          , Wo          , Wo          , Wo          , Wo          
Hh          , Mm          , Mm          , Hh          , Gs^Vht      , Hh          , Gs^Ft       , Gs          , Gs          , Gs          , Gs          , Rr          , Rr          , Gs          , Gs          , Gs          , Gs          , Hh          , Gs          , Gs          , Ce          , Ce          , Ce          , Ce          , Ce          , Ce          , Gs          , Gs          , Gs          , Ww          , Ww          , Ww          , Wo          , Wo          , Wo          , Wo          
Gs          , Mm          , Mm          , Hh          , Gs^Ft       , Gs          , Gs          , Gs          , Gs          , Gs          , Gs^Ft       , Gs          , Gs          , Rr          , Rr          , Gs          , Gs          , Gs          , Gs          , Gs          , Ce          , Ke          , Ce          , 2 Ke        , Gs          , Gs          , Gs          , Gs          , Gs          , Ww          , Ww          , Ww          , Wo          , Wo          , Wo          , Wo          
Mm          , Mm          , Mm          , Hh          , Hh          , Gs^Ft       , Gs^Ft       , Gs          , Hh          , Gs^Ft       , Hh          , Hh          , Gs^Ft       , Gs          , Gs          , Rr          , Rr          , Gs          , Gs          , Gs          , Gs          , Ce          , Gs          , Gs          , Gs          , Gs          , Gs          , Gs          , Gs          , Ww          , Ww          , Ww          , Ww          , Wo          , Wo          , Wo          
Mm          , Mm          , Hh          , Hh          , Gs^Ft       , Gs^Ft       , Hh          , Hh          , Gs^Ft       , Hh          , Hh          , Gs^Ft       , Gs^Ft       , Hh          , Hh          , Gs          , Gs          , Rr          , Rr          , Gs          , Gs          , Gs          , Gs          , Gs          , Gs          , Gs          , Gs          , Gs          , Gs          , Ww          , Ww          , Ww          , Ww          , Wo          , Wo          , Wo          
