border_size=1
usage=map

Gs^Fp       , Gs^Fp       , Gs^Fp       , Gg          , Hh^Fp       , Gg          , Hh          , Gg          , Mm          , Mm          , Mm          , Mm          , Mm^Xm       , Mm          , Mm^Xm       , Mm          , Mm^Xm       , Mm^Xm       , Mm^Xm       , Mm          , Mm          , Mm          , Hh          , Mm          , Hh          , Mm          , Hh^Fp       , Mm          , Mm          , Mm          , Mm          , Mm          , Mm          , Gg          , Gg          
Gs^Fp       , Gs^Fp       , Gs^Fp       , Hh^Fp       , Hh^Fp       , Hh^Fp       , Hh^Fp       , Hh          , Mm          , Mm          , Mm          , Mm^Xm       , Mm^Xm       , Mm^Xm       , Mm^Xm       , Mm^Xm       , Mm^Xm       , Mm^Xm       , Mm          , Mm          , Mm          , Mm          , Hh^Fp       , Hh          , Hh          , Hh^Fp       , Hh^Fp       , Mm          , Hh          , Mm          , Mm          , Mm          , Mm          , Mm          , Mm          
Gg          , Gs^Fp       , Gs^Fp       , Hh^Fp       , Gs^Fp       , Gs^Fp       , Hh^Fp       , Hh          , Mm          , Mm          , Mm          , Mm          , Mm          , Mm^Xm       , Mm^Xm       , Mm^Xm       , Mm          , Mm          , Mm          , Mm          , Hh          , Hh^Fp       , Hh^Vc       , Hh^Fp       , Gs^Fp       , Hh^Fp       , Gs^Fp       , Hh^Fp       , Hh^Fp       , Hh          , Hh^Fp       , Mm          , Mm          , Mm          , Mm          
Gs^Fp       , Gs^Fp       , Gs^Fp       , Gs^Fp       , Hh^Fp       , Hh^Fp       , Hh^Fp       , Hh          , Hh          , Mm          , Mm          , Mm          , Mm          , Mm          , Mm^Xm       , Mm          , Mm          , Mm          , Mm          , Mm          , Hh^Fp       , Hh^Fp       , Gs^Fp       , Gs^Fp       , Gs^Fp       , Gs^Fp       , Gg          , Gs^Fp       , Gs^Fp       , Gs^Fp       , Gg^Vc       , Hh          , Hh          , Mm          , Hh          
Gs^Fp       , Gs^Fp       , Gs^Fp       , Gs^Fp       , Hh^Fp       , Hh^Fp       , Hh^Fp       , Hh          , Hh^Vc       , Hh          , Mm          , Mm          , Mm          , Mm          , Mm^Xm       , Mm          , Mm          , Mm^Vhh      , Hh          , Hh^Fp       , Ce          , Ce          , 4 Ke        , Ce          , Gs^Fp       , Gs^Fp       , Gs^Fp       , Gg          , Gg          , Rr          , Chr         , Chr         , Chr         , Hh          , Hh          
Gg          , Gs^Fp       , Gs^Fp       , Gs^Fp       , Gs^Fp       , Hh^Fp       , Hh^Fp       , Hh^Fp       , Hh          , Hh          , Mm          , Mm          , Mm          , Mm          , Mm^Xm       , Mm          , Mm          , Mm          , Hh          , Hh^Fp       , Hh^Fp       , Ce          , Ce          , Ce          , Gs^Fp       , Re          , Gs^Fp       , Gg          , Rp^Vhc      , Rr          , Chr         , 2 Kh        , Chr         , Hh^Fp       , Hh          
Gg          , Gg^Vc       , Gs^Fp       , Gs^Fp       , Gs^Fp       , Hh^Fp       , Hh^Fp       , Hh^Fp       , Hh^Fp       , Hh          , Hh          , Mm          , Mm          , Mm          , Mm          , Mm^Xm       , Mm          , Mm          , Mm          , Hh          , Hh          , Hh^Fp       , Hh^Fp       , Hh^Fp       , Hh^Fp       , Gs^Fp       , Gs^Fp       , Rr          , Rr          , Rr          , Gg          , Chr         , Gs^Fp       , Hh^Fp       , Hh^Fp       
Gg          , Gg          , Gg          , Gs^Fp       , Gs^Fp       , Hh^Fp       , Gs^Fp       , Gs^Fp       , Gs^Fp       , Hh^Fp       , Hh          , Mm          , Mm          , Mm          , Mm          , Mm^Xm       , Ww          , Mm          , Mm          , Mm          , Mm          , Hh          , Hh^Fp       , Hh^Fp       , Hh^Fp       , Gs^Fp       , Gs^Fp       , Gs^Fp       , Gs^Fp       , Rr          , Gg          , Gg          , Gg          , Gs^Fp       , Gs^Fp       
Ce          , Ce          , Rp          , Ce          , Ce          , Gs^Fp       , Hh^Fp       , Hh^Fp       , Hh^Fp       , Hh^Fp       , Hh          , Hh^Vc       , Mm          , Mm          , Mm          , Mm^Xm       , Wo          , Ww          , Ww          , Mm          , Mm          , Hh^Vc       , Hh          , Hh^Fp       , Hh^Fp       , Gs^Fp       , Gs^Fp       , Gs^Fp       , Gs^Fp       , Rr          , Rr          , Rp^Vhc      , Rp          , Gs^Fp       , Gs^Fp       
Rp          , Rp          , Rp^Vhc      , Rp          , Rp          , Ce          , Hh^Fp       , Hh^Fp       , Hh^Fp       , Hh          , Hh          , Hh          , Mm          , Mm          , Wwr         , Mm          , Wo          , Ww^Vm       , Ww          , Wwr         , Wwr         , Mm          , Hh          , Hh^Fp       , Hh^Fp       , Hh^Fp       , Gs^Fp       , Gs^Fp       , Gg          , Gg          , Rp^Vhc      , Rp          , Rp^Vhc      , Rr          , Rr          
Rp          , Rp^Vhc      , Rp          , Rp^Vhc      , Rp^Vhc      , Rp          , Ce          , Hh^Fp       , Hh^Fp       , Hh^Fp       , Hh          , Hh          , Mm          , Mm          , Wwr         , Ww          , Wo          , Wo          , Ww          , Wo          , Wwr         , Mm          , Hh          , Hh^Fp       , Hh^Fp       , Gs^Fp       , Re          , Re          , Hh          , Hh          , Hh^Fp       , Hh^Fp       , Hh^Fp       , Hh^Fp       , Hh^Fp       
Rp          , Rp          , Ww          , Rp          , Rp^Vhc      , Rp          , Rp          , Gs^Fp       , Gs^Fp       , Hh^Fp       , Hh^Fp       , Hh          , Hh          , Mm          , Ds          , Ww          , Wwr         , Mm          , Wwr         , Ww          , Mm          , Mm          , Hh          , Hh          , Re          , Re          , Hh^Fp       , Gs^Fp       , Hh^Fp       , Hh^Fp       , Hh^Fp       , Hh          , Hh          , Hh          , Hh^Fp       
Rp          , Rp          , Rp          , Rp          , Rp^Vhc      , Rp          , Ce          , Gs^Fp       , Gs^Fp       , Hh^Fp       , Hh^Fp       , Hh^Fp       , Hh          , Mm          , Mm          , Ds          , Mm          , Mm^Xm       , Mm^Xm       , Ww          , Ww          , Hh          , Hh          , Re          , Hh^Fp       , Mm          , Mm          , Mm          , Mm          , Mm          , Mm          , Hh          , Mm          , Hh          , Hh          
Rp          , Rp^Vhc      , Rp^Vhc      , Rp          , Rp          , Rp          , Ce          , Gs^Fp       , Gs^Fp       , Hh^Fp       , Hh^Fp       , Hh^Fp       , Hh          , Hh          , Hh^Vc       , Mm          , Mm          , Mm          , Mm^Xm       , Mm          , Wwf         , Hh^Vc       , Re          , Re          , Hh^Fp       , Hh^Fp       , Hh^Fp       , Hh^Fp       , Mm          , Mm          , Mm          , Mm          , Mm          , Mm          , Hh          
Rp          , Rp          , Rp          , Rp          , Rp          , Ce          , Gs^Fp       , Gs^Fp       , Gs^Fp       , Gs^Fp       , Hh^Fp       , Hh^Fp       , Hh^Fp       , Hh          , Hh          , Mm          , Mm          , Mm^Xm       , Mm          , Mm          , Hh          , Wwf         , Hh^Fp       , Re          , Re          , Gs^Fp       , Gs^Fp       , Hh^Fp       , Hh^Fp       , Mm          , Hh          , Mm          , Hh          , Mm          , Mm          
Gs^Fp       , Ce          , Ce          , Ce          , Gs^Fp       , Gs^Fp       , Gs^Fp       , Gs^Fp       , Gs^Fp       , Gs^Fp       , Hh^Fp       , Hh^Fp       , Hh^Fp       , Hh          , Hh^Fp       , Hh          , Hh          , Mm          , Hh^Fp       , Hh^Fp       , Hh^Fp       , Ww          , Hh^Fp       , Hh^Fp       , Hh^Fp       , Re          , Re          , Gs^Fp       , Gg          , Hh^Fp       , Hh^Fp       , Hh          , Gg^Vc       , Hh          , Hh          
Gs^Fp       , Gs^Fp       , Gs^Fp       , Gs^Fp       , Gs^Fp       , Gs^Fp       , Gs^Fp       , Gs^Fp       , Re          , Gs^Fp       , Gs^Fp       , Hh^Fp       , Gs^Fp       , Hh^Fp       , Hh^Fp       , Hh^Fp       , Hh^Fp       , Hh^Fp       , Gs^Fp       , Hh^Fp       , Hh^Fp       , Wwf         , Hh^Fp       , Hh^Fp       , Gs^Fp       , Gs^Fp       , Gs^Fp       , Re          , Gg          , Gg          , Gg          , Hh^Fp       , Gg          , Hh^Fp       , Hh^Fp       
Gs^Fp       , Gs^Fp       , Gs^Fp       , Gs^Fp       , Gs^Fp       , Gs^Fp       , Gs^Fp       , Gs^Fp       , Gs^Fp       , Gs^Fp       , Gs^Fp       , Gs^Fp       , Gs^Fp       , Gs^Fp       , Hh^Fp       , Hh^Fp       , Hh^Fp       , Hh^Fp       , Hh^Fp       , Gs^Fp       , Gs^Fp       , Wwf         , Ss          , Gs^Fp       , Gs^Fp       , Gs^Fp       , Gs^Fp       , Gg          , Gg          , Gg          , Gg          , Gg          , Gg          , Gg          , Gg          
Gs^Fp       , Gs^Fp       , Gs^Fp       , Gs^Fp       , Gs^Fp       , Gs^Fp       , Gs^Fp       , Gs^Fp       , Gs^Fp       , Gs^Fp       , Gs^Fp       , Gs^Fp       , Gs^Fp       , Gs^Fp       , Gs^Fp       , Gs^Fp       , Gs^Fp       , Hh^Fp       , Gs^Fp       , Gs^Fp       , Ss          , Ww          , Gs^Fp       , Ss^Vhs      , Gs^Fp       , Gs^Fp       , Gg          , Gg          , Gg          , Gg          , Hh          , Gg          , Gg          , Gg          , Gg          
Gs^Fp       , Gs^Fp       , Gs^Fp       , Gs^Fp       , Re          , Gs^Fp       , Gs^Fp       , Gs^Fp       , Gs^Fp       , Re          , Gs^Fp       , Gg          , Gg          , Gg^Vc       , Gs^Fp       , Gs^Fp       , Gs^Fp       , Gs^Fp       , Gs^Fp       , Gs^Fp       , Gs^Fp       , Ww          , Ww          , Gs^Fp       , Gg          , Gg          , Gg          , Hh          , Gg          , Gg          , Gg          , Gg          , Ce          , Gg          , Gg          
Gs^Fp       , Gs^Fp       , Gs^Fp       , Gs^Fp       , Gs^Fp       , Gs^Fp       , Gs^Fp       , Gs^Fp       , Gg          , Gs^Fp       , Gg          , Gg          , Gg          , Gg          , Gg          , Gs^Fp       , Gg          , Gs^Fp       , Gs^Fp       , Gs^Fp       , Ss          , Ww          , Ss          , Ss          , Ss          , Gg          , Gg          , Gg          , Gg          , Gg          , Gg          , Ce          , 3 Ke        , Ce          , Gg          
Gs^Fp       , Gs^Fp       , Gs^Fp       , Gs^Fp       , Gs^Fp       , Gs^Fp       , Gs^Fp       , Gg          , Gg          , Gg          , Ce          , Ce          , Ce          , Gg          , Gg          , Gg          , Gg          , Gg          , Ss^Vhs      , Ss          , Ss          , Ss          , Gs          , Gs^Ft       , Gs^Ft       , Ss          , Gg          , Gg          , Gg          , Gg          , Gg          , Ce          , Ce          , Ce          , Gg          
Gs^Fp       , Gs^Fp       , Gs^Fp       , Gs^Fp       , Gs^Fp       , Gs^Fp       , Gg          , Gg          , Gg          , Gg          , Ce          , 1 Ke        , Ke          , Ce          , Gg          , Gg          , Gg          , Gg          , Ss          , Gs^Ft       , Ds          , Ss          , Ss          , Ss          , Ss          , Ss          , Gg          , Gg^Vc       , Gg          , Gg          , Gg          , Gg          , Gg          , Gg          , Gg          
Gs^Fp       , Gs^Fp       , Gs^Fp       , Gs^Fp       , Gs^Fp       , Gs^Fp       , Gg          , Gg^Vc       , Gg          , Gg          , Gg          , Ce          , Ce          , Ce          , Gg          , Gg          , Gg          , Gg          , Ss          , Ss          , Ss          , Gs^Ft       , Ss          , Gs^Ft       , Ss          , Ss          , Hh          , Hh          , Hh          , Gg          , Gg          , Gg^Vc       , Gg          , Gg          , Gg          
Gs^Fp       , Gs^Fp       , Gs^Fp       , Gs^Fp       , Gs^Fp       , Gs^Fp       , Gg          , Gg          , Gg          , Gg          , Gg          , Gg          , Gg          , Gg          , Gg          , Gg          , Gg          , Gg          , Gg          , Ss          , Ss          , Ss          , Ss          , Ss          , Gg          , Hh          , Gg          , Gg          , Gg          , Gg          , Gg          , Gg          , Gg          , Gg          , Gg          
